'co k o /kɔ/
'y @ /ə/
abbeyfield a - 'b ey v - j e l d /a.'bəɨv.jɛld/
abbie 'a b - j e /'ab.jɛ/
abdwl 'a b - d u l /'ab.dʊl/
abeia (foreign) a - 'b e - j a /a.'bɛ.ja/
abercrâf a - b e r - 'k r aa v /a.bɛr.'kraːv/
abercyrnog a - b e r - 'k @ r - n o g /a.bɛr.'kər.nɔg/
aberdar a - 'b e r - d a r /a.'bɛr.dar/
aberdeuddwr a - b e r - 'd ey - dh u r /a.bɛr.'dəɨ.ðʊr/
abi 'aa - b i /'aː.bɪ/
abiel (foreign) @ - b - j e l /ə.b.jɛl/
abinadab (foreign) a - b i - 'n aa - d a b /a.bɪ.'naː.dab/
abse 'a b - s e /'ab.sɛ/
acac 'a - k a k /'a.kak/
academegwyr a - k a - d e - 'm ee - g uy r /a.ka.dɛ.'mɛː.gʊɨr/
achaia (foreign) a - 'x ai @ /a.'χaɪə/
achan 'aa - x a n /'aː.χan/
achosydd a - 'x oo - s y dh /a.'χɔː.sɨð/
acrefair a k - 'r ee - v ai r /ak.'rɛː.vaɪr/
acwila (foreign) @ - k - w i - l a /ə.k.wɪ.la/
adag 'aa - d a g /'aː.dag/
adborthiant a d - 'b o r - th j a n t /ad.'bɔr.θjant/
addurniedig a - dh y r - 'n j ee - d i g /a.ðɨr.'njɛː.dɪg/
addysgiedig a - dh @ s - 'k j ee - d i g /a.ðəs.'kjɛː.dɪg/
adgynhyrchiad a d - 'g @ n hh @ r - x j a d /ad.'gənhər.χjad/
adgynhyrchu a d - 'g @ n hh @ r - x y /ad.'gənhər.χɨ/
adn 'aa - d a n /'aː.dan/
adnewyddol a d - n e - 'w @ - dh o l /ad.nɛ.'wə.ðɔl/
adt aa - d ii - 't ii /aː.dɪː.'tɪː/
aeddfetach aay dh - 'v e - t a x /ɑɨð.'vɛ.taχ/
aeddfetaf aay dh - 'v e - t a v /ɑɨð.'vɛ.tav/
aelhaearn aay l - 'hh aay - a r n /ɑɨl.'hɑɨ.arn/
aelodau'r aay - 'l oo - d ay r /ɑɨ.'lɔː.daɨr/
aeroflot (foreign) aay - 'r o v - l o t /ɑɨ.'rɔv.lɔt/
aethwy 'aay - th uy /'ɑɨ.θʊɨ/
afaon a - 'v a - o n /a.'va.ɔn/
affeia (foreign) @ - f e - j a /ə.fɛ.ja/
affos 'aa - f o s /'aː.fɔs/
afiechydon a v - j e - 'x @ - d o n /av.jɛ.'χə.dɔn/
afton (foreign) 'a f - t @ n /'af.tən/
agabus (foreign) a - 'g aa - b y s /a.'gaː.bɨs/
agg aa - e - 'g e g /aː.ɛ.'gɛg/
agit 'aa - g i t /'aː.gɪt/
agosach a - 'g oo - s a x /a.'gɔː.saχ/
agosaf a - 'g oo - s a v /a.'gɔː.sav/
agosau a - 'g oo - s ay /a.'gɔː.saɨ/
aheia a - 'hh e - j a /a.'hɛ.ja/
ahia (foreign) 'o ii - @ /'ɔɪː.ə/
ahinoam (foreign) o - hh 'ii - n 'ou m /ɔ.h'ɪː.n'əʊm/
ahitoffel (foreign) o - hh 'ii - t ou - f @ l /ɔ.h'ɪː.təʊ.fəl/
ahitub (foreign) o - hh 'ii - t @ b /ɔ.h'ɪː.təb/
ahïo (foreign) 'o i - o /'ɔɪ.ɔ/
aif ee - ai - 'e f /ɛː.aɪ.'ɛf/
ail-wampio 'ai l - 'w a m - p j o /'aɪl.'wam.pjɔ/
ailddwyfoli ai l - dh uy - 'v o - l i /aɪl.ðʊɨ.'vɔ.lɪ/
ailfandio ai l - 'v a n - d j o /aɪl.'van.djɔ/
ailgomisiynu ai l - g o - m i - s i - '@ - n y /aɪl.gɔ.mɪ.sɪ.'ə.nɨ/
ailgyfri ai l - 'g @ v - r i /aɪl.'gəv.rɪ/
ailorseddu ai - l o r - 's ee - dh y /aɪ.lɔr.'sɛː.ðɨ/
ain 'ai n /'aɪn/
aizlewood 'ee - z @ l - w u d /'ɛː.zəl.wʊd/
akram 'a k - r a m /'ak.ram/
alamar a - 'l a - m a r /a.'la.mar/
alawon a - 'l a - w o n /a.'la.wɔn/
albula a l - 'b y - l a /al.'bɨ.la/
albwms (foreign) 'a l - b u m s /'al.bʊms/
albym (foreign) 'a l - b y m /'al.bɨm/
alcalaidd a l - 'k a - l ai dh /al.'ka.laɪð/
alcaliau a l - 'k a l - j ay /al.'kal.jaɨ/
alcemegwr a l - k e - 'm ee - g u r /al.kɛ.'mɛː.gʊr/
alcwyn 'a l - k uy n /'al.kʊɨn/
aleluia a - l e - 'l y - i - a /a.lɛ.'lɨ.ɪ.a/
alelwia a - l e - 'l u - j a /a.lɛ.'lʊ.ja/
alffeus (foreign) 'a l - f ey s /'al.fəɨs/
alfonsin a l - 'v o n - s i n /al.'vɔn.sɪn/
alford 'a l - v o r d /'al.vɔrd/
alguem a l - 'g y - e m /al.'gɨ.ɛm/
alienum (foreign) a l - 'j e - n y m /al.'jɛ.nɨm/
aliki a - 'l i - k i /a.'lɪ.kɪ/
allanson (foreign) a - 'lh a n - s @ n /a.'ɬan.sən/
allanwr a - 'lh a - n u r /a.'ɬa.nʊr/
allblygol a lh - 'b l @ - g o l /aɬ.'blə.gɔl/
almaenig a l - 'm aay - n i g /al.'mɑɨ.nɪg/
als 'a l s /'als/
alvear a l - 'v e - a r /al.'vɛ.ar/
alvra 'a l - v r a /'al.vra/
alyn 'a - l y n /'a.lɨn/
amal 'a - m a l /'a.mal/
amal (foreign) 'a - m a l /'a.mal/
amaleciad (foreign) a - 'm a - l e k - j a d /a.'ma.lɛk.jad/
amaleciaid (foreign) a - 'm a - l e k - j ai d /a.'ma.lɛk.jaɪd/
ambarel (foreign) a m - 'b a - r e l /am.'ba.rɛl/
amddiffynol a m - dh i - 'f @ - n o l /am.ðɪ.'fə.nɔl/
amf aa - e - 'm e v /aː.ɛ.'mɛv/
amgaeëdig a m - g aay - 'e - d i g /am.gɑɨ.'ɛ.dɪg/
amgau 'a m - g ay /'am.gaɨ/
amgylcheddoedd a m - g @ l - 'x ee - dh oy dh /am.gəl.'χɛː.ðɔɨð/
amiwsments (foreign) a - 'm iu s - m e n t s /a.'mɪʊs.mɛnts/
amlach 'a m - l a x /'am.laχ/
amlbreswyl a m l - 'b r ee - s uy l /aml.'brɛː.sʊɨl/
amlddefnydd a m l - 'dh e v - n y dh /aml.'ðɛv.nɨð/
amled 'a m - l e d /'am.lɛd/
amlgyfrannog a m l - g @ v - 'r a - n o g /aml.gəv.'ra.nɔg/
amlochredd a m - 'l o x - r e dh /am.'lɔχ.rɛð/
amlweddog a m l - 'w ee - dh o g /aml.'wɛː.ðɔg/
amlycach a m - 'l @ - k a x /am.'lə.kaχ/
amlycaf a m - 'l @ - k a v /am.'lə.kav/
amlycaf (foreign) a m - 'l @ - k a v /am.'lə.kav/
ammffibiad a m - 'f i b - j a d /am.'fɪb.jad/
ammoniaid (foreign) 'a - m o n - j ai d /'a.mɔn.jaɪd/
amnon (foreign) a m - 'n o n /am.'nɔn/
amo 'a - m o /'a.mɔ/
amrywiaethol a m - r yu - 'j aay - th o l /am.rɨʊ.'jɑɨ.θɔl/
amsar (foreign) 'a m - s a r /'am.sar/
amwlch (foreign) 'a - m u l x /'a.mʊlχ/
anadeiladol a - n a - d ei - 'l aa - d o l /a.na.dəɪ.'laː.dɔl/
anaelon a - 'n aay - l o n /a.'nɑɨ.lɔn/
anamal a - 'n a - m a l /a.'na.mal/
anatiomaros a - n a t - j o - 'm a - r o s /a.nat.jɔ.'ma.rɔs/
anc (foreign) 'a ng k /'aŋk/
and/or 'a n - d oa r /'an.dɔar/
aneddle a - 'n e dh - l e /a.'nɛð.lɛ/
anfethodistaidd a n - v e - th o - 'd i s - t ai dh /an.vɛ.θɔ.'dɪs.taɪð/
anghenfilod a ng hh e n - 'v i - l o d /aŋhɛn.'vɪ.lɔd/
anhawsterau a n hh au s - 't e - r ay /anhaʊs.'tɛ.raɨ/
anhebyg 'a n hh ee - b y g /'anhɛː.bɨg/
anheyrngarwch 'a n hh ey r - 'ng a - r u x /'anhəɨr.'ŋa.rʊχ/
anima (foreign) a - 'n i - m a /a.'nɪ.ma/
animateurs a - n i - m a - 't @@ z /a.nɪ.ma.'tɜːz/
ankst (foreign) 'a n k s t /'ankst/
anllenyddol a n - lh e - 'n @ - dh o l /an.ɬɛ.'nə.ðɔl/
annales (foreign) a - 'n a - l e s /a.'na.lɛs/
anneall a - 'n e - a lh /a.'nɛ.aɬ/
annirnad a - 'n i r - n a d /a.'nɪr.nad/
anno (foreign) 'a - n o /'a.nɔ/
anoddach a - 'n oo - dh a x /a.'nɔː.ðaχ/
anoddaf a - 'n oo - dh a v /a.'nɔː.ðav/
anomali (foreign) a - n o - 'm a - l i /a.nɔ.'ma.lɪ/
anothe (foreign) @ - n '@ - dh @ /ə.n'ə.ðə/
anrhodd (foreign) a n - rh o dh /an.r̥ɔð/
ansensitif a n - s e n - 's i - t i v /an.sɛn.'sɪ.tɪv/
ansokia a n - 's o k - j a /an.'sɔk.ja/
anthropos (foreign) a n - 'th r o - p o s /an.'θrɔ.pɔs/
antiochia (foreign) a n - t j o x - j a /an.tjɔχ.ja/
antiqua (foreign) a n - 't i - k a /an.'tɪ.ka/
aoq ee - oo - 'k iu /ɛː.ɔː.'kɪʊ/
aoql ee - oo - k iu - 'e l /ɛː.ɔː.kɪʊ.'ɛl/
aparatws a - p a - 'r a - t u s /a.pa.'ra.tʊs/
apce 'a p - k e /'ap.kɛ/
apel 'a - p e l /'a.pɛl/
apolloni a - p @ - 'l oo - n i /a.pə.'lɔː.nɪ/
apolos (foreign) @ - p 'ou - l ou z /ə.p'əʊ.ləʊz/
appreciaite (foreign) @ - p r 'ii - sh @ - 'ai t /ə.pr'ɪː.ʃə.'aɪt/
ar-sgrîn 'a r s - 'k r ii n /'ars.'krɪːn/
ara 'a - r a /'a.ra/
arabela a - r a - 'b e - l a /a.ra.'bɛ.la/
arabrab a - 'r a b - r a b /a.'rab.rab/
arafach a - 'r aa - v a x /a.'raː.vaχ/
arben 'a r - b e n /'ar.bɛn/
archaeolegol a r - x aay - o - 'l ee - g o l /ar.χɑɨ.ɔ.'lɛː.gɔl/
archaeolegwyr a r - x aay - o - 'l ee - g uy r /ar.χɑɨ.ɔ.'lɛː.gʊɨr/
archaeolegydd a r - x aay - o - 'l ee - g y dh /ar.χɑɨ.ɔ.'lɛː.gɨð/
arddangosiadol a r - dh a ng - g o - 'sh aa - d o l /ar.ðaŋ.gɔ.'ʃaː.dɔl/
ardderchogrwydd a r - dh e r - 'x o g - r uy dh /ar.ðɛr.'χɔg.rʊɨð/
arfar (foreign) 'a r - v a r /'ar.var/
arfor 'a r - v o r /'ar.vɔr/
argian 'a r - g j a n /'ar.gjan/
argian (foreign) 'a r - g j a n /'ar.gjan/
argol (foreign) 'a r - g o l /'ar.gɔl/
argyhoeddiedig a r - g @ - hh oy dh - 'j ee - d i g /ar.gə.hɔɨð.'jɛː.dɪg/
argyle a r - 'g @ - l e /ar.'gə.lɛ/
arhosfan 'a r hh o s - v a n /'arhɔs.van/
aristocratiaeth a - r i s - t o k - 'r a t - j aay th /a.rɪs.tɔk.'rat.jɑɨθ/
aristotlys a - r i s - 't o t - l y s /a.rɪs.'tɔt.lɨs/
arkus (foreign) 'a r - k y s /'ar.kɨs/
arlein 'a r - l ei n /'ar.ləɪn/
arosfan a - 'r o s - v a n /a.'rɔs.van/
arosfannau a - r o s - 'v a - n ay /a.rɔs.'va.naɨ/
arsi 'a r - s i /'ar.sɪ/
arthreitus (foreign) a r - 'th r ei - t y s /ar.'θrəɪ.tɨs/
arthuraidd a r - 'th y - r ai dh /ar.'θɨ.raɪð/
artistri a r - 't i s - t r i /ar.'tɪs.trɪ/
artorius a r - 't o - r i - y s /ar.'tɔ.rɪ.ɨs/
arun 'a - r @ n /'a.rən/
arwerthfa a r - 'w e r th - v a /ar.'wɛrθ.va/
arwyddocad a - r uy - 'dh o - k a d /a.rʊɨ.'ðɔ.kad/
arwynebu a - r uy - 'n ee - b y /a.rʊɨ.'nɛː.bɨ/
asa ee - e - 's ee /ɛː.ɛ.'sɛː/
asbrin (foreign) 'a s - p r i n /'as.prɪn/
asc 'a s k /'ask/
asc (foreign) 'a s k /'ask/
ase aa - e - 's ee /aː.ɛ.'sɛː/
aseau a - 's e - ay /a.'sɛ.aɨ/
ashburnham a sh - 'b y r n - hh a m /aʃ.'bɨrn.ham/
asiantiaid (foreign) a - 'sh a n - t j ai d /a.'ʃan.tjaɪd/
asn ee - e - 's e n /ɛː.ɛ.'sɛn/
assheton (foreign) @ - s 'e - t @ n /ə.s'ɛ.tən/
astecs (foreign) 'a s - t e k s /'as.tɛks/
astroffisegwyr a s - t r o - f i - 's ee - g uy r /as.trɔ.fɪ.'sɛː.gʊɨr/
astudio'r a s - 't y d - j o r /as.'tɨd.jɔr/
atas ee - t ii - ee - 'e s /ɛː.tɪː.ɛː.'ɛs/
atborth 'a t - b o r th /'at.bɔrθ/
atgyfeirio a t - g @ - 'v ei r - j o /at.gə.'vəɪr.jɔ/
atgyfodedig a t - g @ - v o - 'd ee - d i g /at.gə.vɔ.'dɛː.dɪg/
athel 'aa - th e l /'aː.θɛl/
athenae (foreign) a - 'th e - n aay /a.'θɛ.nɑɨ/
athreitus (foreign) a th - 'r ei - t y s /aθ.'rəɪ.tɨs/
atodedig a - t o - 'd ee - d i g /a.tɔ.'dɛː.dɪg/
ats ee - t ii - 'e s /ɛː.tɪː.'ɛs/
attilio a - 't i l - j o /a.'tɪl.jɔ/
ausra 'ay s - r a /'aɨs.ra/
autostrada ay - t o s - 't r aa - d a /aɨ.tɔs.'traː.da/
averill a - 'v e - r i lh /a.'vɛ.rɪɬ/
averina a - v e - 'r i - n a /a.vɛ.'rɪ.na/
awd (foreign) 'au d /'aʊd/
awdio (foreign) 'au d - j o /'aʊd.jɔ/
awdit (foreign) 'au - d i t /'aʊ.dɪt/
awduron au - 'd y - r o n /aʊ.'dɨ.rɔn/
awelon a - 'w e - l o n /a.'wɛ.lɔn/
aws ee - d @ - b l iu - 'e s /ɛː.də.blɪʊ.'ɛs/
awstralasia au s - t r a - 'l a - sh a /aʊs.tra.'la.ʃa/
azariah a - 'z a r - j a hh /a.'zar.jah/
b (foreign) b /b/
b (nmcy) 'b ii /'bɪː/
b (nmen) 'b ii /'bɪː/
b/d b ii - 'd ii /bɪː.'dɪː/
b/f b ii - 'e f /bɪː.'ɛf/
bV b v /bv/
babanod b a - 'b a - n o d /ba.'ba.nɔd/
babis (foreign) 'b aa - b i s /'baː.bɪs/
baconia b a - 'k o n - j a /ba.'kɔn.ja/
badonis b a - 'd o - n i s /ba.'dɔ.nɪs/
badshah 'b a - jh a hh /'ba.dʒah/
baeddod 'b aay - dh o d /'bɑɨ.ðɔd/
baet b aay t /bɑɨt/
bafaria b a - 'v a r - j a /ba.'var.ja/
bagot 'b aa - g o t /'baː.gɔt/
baines 'b ai - n e s /'baɪ.nɛs/
bakewell b a - 'k e - w e lh /ba.'kɛ.wɛɬ/
baladeulyn b a - l a - 'd ey - l y n /ba.la.'dəɨ.lɨn/
balans (foreign) 'b a - l a n s /'ba.lans/
balcanaidd b a l - 'k a - n ai dh /bal.'ka.naɪð/
balsom 'b o l - s @ m /'bɔl.səm/
bambw 'b a m - b u /'bam.bʊ/
bambw (foreign) 'b a m - b u /'bam.bʊ/
bandeang b a n - 'd e - a ng /ban.'dɛ.aŋ/
bandio 'b a n - d j o /'ban.djɔ/
banna 'b a - n a /'ba.na/
baragwâi b a - r a g - 'w aa - i /ba.rag.'waː.ɪ/
barbiciw (foreign) b a r - 'b i - k iu /bar.'bɪ.kɪʊ/
baricêds (foreign) b a - r i - 'k ee d s /ba.rɪ.'kɛːds/
barnardo b a r - 'n a r - d o /bar.'nar.dɔ/
barsabas (foreign) 'b a r - 's aa - b a s /'bar.'saː.bas/
basach 'b aa - s a x /'baː.saχ/
basai b a - s ai /ba.saɪ/
basport (foreign) 'b a s - p o r t /'bas.pɔrt/
batris (foreign) 'b a t - r i s /'bat.rɪs/
baudoche b ay - 'd oo - x e /baɨ.'dɔː.χɛ/
bayly b a - '@ - l y /ba.'ə.lɨ/
bd b d /bd/
bdcw b ii - d ii - e - 'k uu /bɪː.dɪː.ɛ.'kʊː/
bdms b ii - d ii - e - 'm e s /bɪː.dɪː.ɛ.'mɛs/
beaumaris b e - ay - 'm a - r i s /bɛ.aɨ.'ma.rɪs/
bebb 'b e b /'bɛb/
bebb-jones 'b e b - 'jh ou n z /'bɛb.'dʒəʊnz/
bec (foreign) 'b e k /'bɛk/
beca 'b e - k a /'bɛ.ka/
becorath (foreign) b i - k 'oo r aa th /bɪ.k'ɔːraːθ/
becws (foreign) 'b e - k u s /'bɛ.kʊs/
beddoe 'b ee - dh oy /'bɛː.ðɔɨ/
beeroth (foreign) b 'i r oo th /b'ɪrɔːθ/
beerseba (foreign) b 'i r - 's ee - b a /b'ɪr.'sɛː.ba/
beganifs b e - 'g a - n i v s /bɛ.'ga.nɪvs/
begw 'b ee - g u /'bɛː.gʊ/
beicarb (foreign) 'b ei - k a r b /'bəɪ.karb/
beics (foreign) 'b ei k s /'bəɪks/
beipan (foreign) 'b ei - p a n /'bəɪ.pan/
belem 'b e - l e m /'bɛ.lɛm/
belffast 'b e l - f a s t /'bɛl.fast/
belka 'b e l - k a /'bɛl.ka/
bellairs 'b e - lh ai r s /'bɛ.ɬaɪrs/
bellamys 'b e - l @ - m i s /'bɛ.lə.mɪs/
bencawr 'b e ng - k au r /'bɛŋ.kaʊr/
bendithio’r (foreign) b e n - 'd i th - j o r /bɛn.'dɪθ.jɔr/
benfield 'b e n - f ii l d /'bɛn.fɪːld/
benfor 'b e n - v o r /'bɛn.vɔr/
beni 'b e - n i /'bɛ.nɪ/
bensaerniol b e n - 's aay r - n j o l /bɛn.'sɑɨr.njɔl/
bensednne (foreign) b e n - 's e d - n e /bɛn.'sɛd.nɛ/
bermo 'b e r - m o /'bɛr.mɔ/
bernez 'b e r - n e z /'bɛr.nɛz/
bernina b e r - 'n i - n a /bɛr.'nɪ.na/
besec (foreign) b i - s 'e k /bɪ.s'ɛk/
besetas (foreign) b e - 's e - t a s /bɛ.'sɛ.tas/
betha 'b ee - th a /'bɛː.θa/
bethsaida b e th - 's ai - d a /bɛθ.'saɪ.da/
bevin (foreign) 'b e - v i n /'bɛ.vɪn/
beyah 'b ey - a hh /'bəɨ.ah/
beza 'b e - z a /'bɛ.za/
bholu 'b hh o - l y /'bhɔ.lɨ/
bibby 'b i - b y /'bɪ.bɨ/
bibyl (foreign) 'b ii - b y l /'bɪː.bɨl/
bien (foreign) 'b j e n /'bjɛn/
bigoudenn (foreign) b i - 'g oy - d e n /bɪ.'gɔɨ.dɛn/
bigw 'b ii - g u /'bɪː.gʊ/
bilbord 'b i l - b o r d /'bɪl.bɔrd/
bilidowcars b i - l i - 'd ou - k a r s /bɪ.lɪ.'dəʊ.kars/
bilo 'b i - l o /'bɪ.lɔ/
bio-amrywiaeth 'b j oo - a m - 'r yu - j aay th /'bjɔː.am.'rɨʊ.jɑɨθ/
biotechnegol b j o - t e x - 'n ee - g o l /bjɔ.tɛχ.'nɛː.gɔl/
birkett 'b i r - k e t /'bɪr.kɛt/
birt 'b i r t /'bɪrt/
bist (foreign) 'b i s t /'bɪst/
bl (foreign) b l /bl/
blaengareddau b l aay - ng a - 'r ee - dh ay /blɑɨ.ŋa.'rɛː.ðaɨ/
blaengarwch 'b l aay - 'ng a - r u x /'blɑɨ.'ŋa.rʊχ/
blaenycwm 'b l aay - 'n @ - k u m /'blɑɨ.'nə.kʊm/
blasdy (foreign) b l 'a s - d ii /bl'as.dɪː/
blasdŷ (foreign) b l 'a s - 'd yy /bl'as.'dɨː/
blastar (foreign) 'b l a s - t a r /'blas.tar/
blesawnt 'b l ee - s au n t /'blɛː.saʊnt/
blincars (foreign) 'b l i ng - k a r s /'blɪŋ.kars/
blj b l jh /bldʒ/
blocbystar (foreign) b l o k - 'b @ s - t a r /blɔk.'bəs.tar/
bloda 'b l oo - d a /'blɔː.da/
blode 'b l oo d /'blɔːd/
blw-byrd (foreign) 'b l uu - 'b y r d /'blʊː.'bɨrd/
blyb (foreign) 'b l yy b /'blɨːb/
bmibaby b ii - e - m ai - 'b ei - b i /bɪː.ɛ.maɪ.'bəɪ.bɪ/
bmr b ii - e - 'm aa r /bɪː.ɛ.'maːr/
bms b ii - e - 'm e s /bɪː.ɛ.'mɛs/
bnf b ii - e - 'n e f /bɪː.ɛ.'nɛf/
bnr b n r /bnr/
bobtu 'b o b - t y /'bɔb.tɨ/
bocsaid (foreign) 'b o k - s ai d /'bɔk.saɪd/
bocsus (foreign) 'b o k - s y s /'bɔk.sɨs/
bodhyfryd b o d - 'hh @ v - r y d /bɔd.'həv.rɨd/
bodley 'b o d - l ey /'bɔd.ləɨ/
bodwigiad b o d - 'w i g - j a d /bɔd.'wɪg.jad/
boehme 'b oy hh - m e /'bɔɨh.mɛ/
bohemaidd b o - 'hh e - m ai dh /bɔ.'hɛ.maɪð/
boints (foreign) 'b oi n t s /'bɔɪnts/
bolisiau b o - 'l i - sh ay /bɔ.'lɪ.ʃaɨ/
bolltiau 'b o lh t - j ay /'bɔɬt.jaɨ/
bon 'b o n /'bɔn/
bookstart 'b u k - s t aa t /'bʊk.staːt/
bordyn (foreign) 'b o r - d y n /'bɔr.dɨn/
boscawen b o s - 'k au - e n /bɔs.'kaʊ.ɛn/
bosnia-hercegofenia 'b o s - n j a - hh e r - k e - g o - 'v e n - j a /'bɔs.nja.hɛr.kɛ.gɔ.'vɛn.ja/
bosnieg 'b o s - n j e g /'bɔs.njɛg/
bossia 'b o s - j a /'bɔs.ja/
bosyn (foreign) 'b oo - s y n /'bɔː.sɨn/
bouchard 'b oy - x a r d /'bɔɨ.χard/
bourchier (foreign) b 'au r - k ii - @r /b'aʊr.kɪː.ər/
bourree (foreign) 'b oy - r ii /'bɔɨ.rɪː/
boutros 'b oy t - r o s /'bɔɨt.rɔs/
braddock 'b r aa - dh o k /'braː.ðɔk/
bradle 'b r a d - l e /'brad.lɛ/
brasach 'b r aa - s a x /'braː.saχ/
bravuogn b r a - v y - 'oo - g o n /bra.vɨ.'ɔː.gɔn/
breblian 'b r e b - l j a n /'brɛb.ljan/
brec (foreign) 'b r e k /'brɛk/
brechdana b r e x - 'd a - n a /brɛχ.'da.na/
brecknock 'b r e k - n o k /'brɛk.nɔk/
brecknockshire b r e k - n o k - 'sh i - r e /brɛk.nɔk.'ʃɪ.rɛ/
brecon (foreign) 'b r e - k o n /'brɛ.kɔn/
breiddyn 'b r ei - dh y n /'brəɪ.ðɨn/
brenig 'b r e - n i g /'brɛ.nɪg/
breos 'b r e - o s /'brɛ.ɔs/
brezhoneg (foreign) b r e z - 'hh o - n e g /brɛz.'hɔ.nɛg/
briony 'b r ai - @ - n i /'braɪ.ə.nɪ/
britanniae (foreign) b r i - 't a n - j aay /brɪ.'tan.jɑɨ/
britanniarum (foreign) b r i - t a n - 'j a - r y m /brɪ.tan.'ja.rɨm/
britannicae (foreign) b r i - t a - 'n i - k aay /brɪ.ta.'nɪ.kɑɨ/
brithyllod b r i - 'th @ - lh o d /brɪ.'θə.ɬɔd/
britton 'b r i - t o n /'brɪ.tɔn/
brittonum (foreign) b r i - 't o - n y m /brɪ.'tɔ.nɨm/
broffit (foreign) 'b r oo - f i t /'brɔː.fɪt/
brogaod b r o - 'g a - o d /brɔ.'ga.ɔd/
brooksbank 'b r u k s - b a ng k /'brʊks.baŋk/
broster 'b r o s - t @ r /'brɔs.tər/
brothen 'b r oo - th e n /'brɔː.θɛn/
broughton 'b r oy g - hh t o n /'brɔɨg.htɔn/
brownlow 'b r ou n - l ou /'brəʊn.ləʊ/
broydd 'b r oy dh /'brɔɨð/
brunner 'b r y - n e r /'brɨ.nɛr/
brunstrom 'b r @ n s - t r o m /'brəns.trɔm/
brut (foreign) 'b r y t /'brɨt/
brwshis (foreign) 'b r u - sh i s /'brʊ.ʃɪs/
bryndias 'b r @ n - d j a s /'brən.djas/
brynkinalt b r @ n - 'k i - n a l t /brən.'kɪ.nalt/
brynle 'b r @ n - l e /'brən.lɛ/
brynley 'b r @ n - l ey /'brən.ləɨ/
brynmulan b r @ n - 'm y - l a n /brən.'mɨ.lan/
brynyffynnon b r @ - n @ - 'f @ - n o n /brə.nə.'fə.nɔn/
brytanaidd b r @ - 't a - n ai dh /brə.'ta.naɪð/
brytaniaid b r @ - 't a n - j ai d /brə.'tan.jaɪd/
brytaniait (foreign) b r @ - 't a n - j ai t /brə.'tan.jaɪt/
brytannicae (foreign) b r @ - t a - 'n i - k aay /brə.ta.'nɪ.kɑɨ/
brêcs (foreign) 'b r ee k s /'brɛːks/
brên 'b r ee n /'brɛːn/
bu'n 'b y n /'bɨn/
bu'r 'b y r /'bɨr/
buais b yy - ai s /bɨː.aɪs/
buaist b yy - ai s t /bɨː.aɪst/
buasen b j a - s e n /bja.sɛn/
buddsoddiant b y dh - 's o dh - j a n t /bɨð.'sɔð.jant/
buganda b y - 'g a n - d a /bɨ.'gan.da/
bulkeley b y l - 'k e - l ey /bɨl.'kɛ.ləɨ/
bullinger b y - 'lh i - ng e r /bɨ.'ɬɪ.ŋɛr/
bunhill 'b y n hh i lh /'bɨnhɪɬ/
bunyan 'b y - n @ - a n /'bɨ.nə.an/
burritt 'b y - r i t /'bɨ.rɪt/
buscemi b y s - 'k e - m i /bɨs.'kɛ.mɪ/
buse 'b yy - s e /'bɨː.sɛ/
busieness (foreign) b 'i z - - n @ s /b'ɪz..nəs/
butlin 'b y t - l i n /'bɨt.lɪn/
butlins 'b y t - l i n s /'bɨt.lɪns/
bwer b w e r /bwɛr/
bwganod b u - 'g a - n o d /bʊ.'ga.nɔd/
bwriedit b u - r i - 'e - d i t /bʊ.rɪ.'ɛ.dɪt/
bwsiau 'b u - sh ay /'bʊ.ʃaɨ/
bwtsiwr (foreign) 'b u - ch iu r /'bʊ.tʃɪʊr/
bwysicach b uy - 's i - k a x /bʊɨ.'sɪ.kaχ/
bwysicaf b uy - 's i - k a v /bʊɨ.'sɪ.kav/
bwysiced b uy - 's i - k e d /bʊɨ.'sɪ.kɛd/
bwystfilod b uy s t - 'v i - l o d /bʊɨst.'vɪ.lɔd/
bwystfilod (foreign) b uy s t - 'v i - l o d /bʊɨst.'vɪ.lɔd/
bwytwyr 'b uy - t uy r /'bʊɨ.tʊɨr/
byclins 'b @ k - l i n s /'bək.lɪns/
byddai'n b @ - dh ai n /bə.ðaɪn/
byddai'r b @ - dh ai r /bə.ðaɪr/
bydde 'b @ - dh e /'bə.ðɛ/
bydeang b @ - 'd e - a ng /bə.'dɛ.aŋ/
byff (foreign) 'b yy f /'bɨːf/
byffs (foreign) 'b y f s /'bɨfs/
byls (foreign) 'b y l s /'bɨls/
byngalos b @ - 'ng a - l o s /bə.'ŋa.lɔs/
byrraf 'b @ - r a v /'bə.rav/
byta 'b @ - t a /'bə.ta/
byta (foreign) 'b @ - t a /'bə.ta/
bywiocaf b yu - 'j o - k a v /bɨʊ.'jɔ.kav/
bywydegol b @ - w @ - 'd ee - g o l /bə.wə.'dɛː.gɔl/
béroul 'b e - 'r o - y l /'bɛ.'rɔ.ɨl/
bêbi 'b ee - b i /'bɛː.bɪ/
c 's ii /'sɪː/
c (nmcy) 'e k /'ɛk/
c.o.f. e - k oo - 'e v /ɛ.kɔː.'ɛv/
caay k aa - y /kaː.ɨ/
cacp e - k aa - e k - 'p ii /ɛ.kaː.ɛk.'pɪː/
cadarnach k a - 'd a r - n a x /ka.'dar.naχ/
cadarnaf k a - 'd a r - n a v /ka.'dar.nav/
cadbury (foreign) k a d - 'b y - r y /kad.'bɨ.rɨ/
cadoci (foreign) k a - 'd o - k i /ka.'dɔ.kɪ/
cadw'n 'k a d - w n /'kad.wn/
cadw'r 'k a d - w r /'kad.wr/
cadwen 'k a d - w e n /'kad.wɛn/
cadwriaethwyr k a - d u r - 'j aay - th uy r /ka.dʊr.'jɑɨ.θʊɨr/
caebrynia k aay b - 'r @ n - j a /kɑɨb.'rən.ja/
caefadog k aay - 'v aa - d o g /kɑɨ.'vaː.dɔg/
caer-gaint 'k aay r - 'g ai n t /'kɑɨr.'gaɪnt/
caer-grawnt 'k aay r - 'g r au n t /'kɑɨr.'graʊnt/
caerl 'k aay r l /'kɑɨrl/
caerlleon k aay r - 'lh e - o n /kɑɨr.'ɬɛ.ɔn/
caernarvon (foreign) k aay r - 'n a r - v @ n /kɑɨr.'nar.vən/
caernarvon (foreign) k aay r - 'n a r - v o n /kɑɨr.'nar.vɔn/
caernarvonshire (foreign) k aay r - 'n a r - v @ n - sh 'ai r /kɑɨr.'nar.vən.ʃ'aɪr/
caet s ii - ee - ii - 't ii /sɪː.ɛː.ɪː.'tɪː/
caeëdig k aay - 'e - d i g /kɑɨ.'ɛ.dɪg/
caffes 'k aa - f e s /'kaː.fɛs/
caffis 'k aa - f i s /'kaː.fɪs/
cafs s ii - ee - e - 'f e s /sɪː.ɛː.ɛ.'fɛs/
caia 'k a - j a /'ka.ja/
calanmai k a - 'l a n - m ai /ka.'lan.maɪ/
calderon k a l - 'd e - r o n /kal.'dɛ.rɔn/
caledfwlch k a - 'l e d - v u l x /ka.'lɛd.vʊlχ/
caletach k a - 'l e - t a x /ka.'lɛ.taχ/
caletaf k a - 'l e - t a v /ka.'lɛ.tav/
caleted k a - 'l e - t e d /ka.'lɛ.tɛd/
calfari k a l - 'v a - r i /kal.'va.rɪ/
calfiniaid k a l - 'v i n - j ai d /kal.'vɪn.jaɪd/
califfornia k a - l i - 'f o r - n j a /ka.lɪ.'fɔr.nja/
caligwla k a - l i - 'g u - l a /ka.lɪ.'gʊ.la/
callach 'k a - lh a x /'ka.ɬaχ/
calongaled k a - l o - 'ng a - l e d /ka.lɔ.'ŋa.lɛd/
caloriau k a - 'l o r - j ay /ka.'lɔr.jaɨ/
camara k a - 'm a - r a /ka.'ma.ra/
camas (foreign) 'k a - m a s /'ka.mas/
cambria (foreign) 'k a m b - r j a /'kamb.rja/
cambriae (foreign) 'k a m b - r j aay /'kamb.rjɑɨ/
camdrin 'k a m - d r i n /'kam.drɪn/
camelod k a - 'm e - l o d /ka.'mɛ.lɔd/
camerau k a - 'm e - r ay /ka.'mɛ.raɨ/
camlasau k a m - 'l aa - s ay /kam.'laː.saɨ/
camrau 'k a m - r ay /'kam.raɨ/
canawon k a - 'n a - w o n /ka.'na.wɔn/
canfas 'k a n - v a s /'kan.vas/
canfyddwyd k a n - 'v @ - dh uy d /kan.'və.ðʊɨd/
caniat 'k a n - j a t /'kan.jat/
caniatau k a n - 'j a - t ay /kan.'ja.taɨ/
canmil 'k a n - m i l /'kan.mɪl/
canoloesoedd k a - n o - 'l oy - s oy dh /ka.nɔ.'lɔɨ.sɔɨð/
canpunt 'k a n - p y n t /'kan.pɨnt/
capal (foreign) 'k a - p a l /'ka.pal/
capelgarwch k a - p e l - 'g a - r u x /ka.pɛl.'ga.rʊχ/
caplandy k a p - 'l a n - d y /kap.'lan.dɨ/
capm s ii - ee - p ii - 'e m /sɪː.ɛː.pɪː.'ɛm/
captan (foreign) 'k a p - t a n /'kap.tan/
caradoc k a - 'r aa - d o k /ka.'raː.dɔk/
carael 'k a - r aay l /'ka.rɑɨl/
carafan k a - 'r aa - v a n /ka.'raː.van/
carafannau k a - r a - 'v a - n ay /ka.ra.'va.naɨ/
carafanwyr k a - r a - 'v a - n uy r /ka.ra.'va.nʊɨr/
carannog k a - 'r a - n o g /ka.'ra.nɔg/
caredicach k a - r e - 'd i - k a x /ka.rɛ.'dɪ.kaχ/
cariadog k a r - 'j aa - d o g /kar.'jaː.dɔg/
cariadon k a r - 'j aa - d o n /kar.'jaː.dɔn/
caribi k a - 'r ii - b i /ka.'rɪː.bɪ/
caridad k a - 'r ii - d a d /ka.'rɪː.dad/
carlitos k a r - 'l i - t o s /kar.'lɪ.tɔs/
carnero (foreign) k a r - 'n e - r o /kar.'nɛ.rɔ/
carnhuanawc k a r n - hh y - 'a - n au k /karn.hɨ.'a.naʊk/
caroll 'k a - r o lh /'ka.rɔɬ/
carteret k a r - t @ - 'r e t /kar.tə.'rɛt/
cartre 'k a r - t r e /'kar.trɛ/
cartwn 'k a r - t u n /'kar.tʊn/
carwed 'k a r - w e d /'kar.wɛd/
carwenna k a r - 'w e - n a /kar.'wɛ.na/
caseion k a - 's e - j o n /ka.'sɛ.jɔn/
caset (foreign) 'k aa - s e t /'kaː.sɛt/
casgenaid k a s - 'k e - n ai d /kas.'kɛ.naɪd/
casi (foreign) 'k aa - s i /'kaː.sɪ/
casia 'k a - sh a /'ka.ʃa/
casiaid 'k a - sh ai d /'ka.ʃaɪd/
cassell 'k a - s e lh /'ka.sɛɬ/
castall (foreign) 'k a s - t a lh /'kas.taɬ/
castellamare k a s - t e - lh a - 'm a - r e /kas.tɛ.ɬa.'ma.rɛ/
castiglione k a s - t i g - 'l j o - n e /kas.tɪg.'ljɔ.nɛ/
catalana k a - t @ - 'l aa - n @ /ka.tə.'laː.nə/
catalunya k a - t @ - 'l u n - j @ /ka.tə.'lʊn.jə/
categoriau k a - t e - 'g o r - j ay /ka.tɛ.'gɔr.jaɨ/
causebrook k ay - 's e b - r oo k /kaɨ.'sɛb.rɔːk/
cawdor 'k au - d o r /'kaʊ.dɔr/
cbac 'k b a k /'kbak/
cbsw e k - b ii - e - 's uu /ɛk.bɪː.ɛ.'sʊː/
cch s ii - s ii - 'ee ch /sɪː.sɪː.'ɛːtʃ/
ccll k lh /kɬ/
cd-romau 'k d r o - m ay /'kdrɔ.maɨ/
cdll k d lh /kdɬ/
cee e - k ee - 'ee /ɛ.kɛː.'ɛː/
cefin 'k e - v i n /'kɛ.vɪn/
cefnamwlch k e v - 'n a - m u l x /kɛv.'na.mʊlχ/
cefngwlad 'k e v - ng lw - a d /'kɛv.ŋlw.ad/
cefnogi'r k e v - 'n oo - g i r /kɛv.'nɔː.gɪr/
cefnsyth 'k e v - n s y th /'kɛv.nsɨθ/
cegiad (foreign) 'k e g - j a d /'kɛg.jad/
ceila (foreign) 'k ei - l @ /'kəɪ.lə/
ceiliogod k ei l - 'j oo - g o d /kəɪl.'jɔː.gɔd/
ceisydd 'k ei - s y dh /'kəɪ.sɨð/
celtec 'k e l - t e k /'kɛl.tɛk/
celtig 'k e l - t i g /'kɛl.tɪg/
celyddon k e - 'l @ - dh o n /kɛ.'lə.ðɔn/
celydon k e - 'l @ - d o n /kɛ.'lə.dɔn/
celynen k e - 'l @ - n e n /kɛ.'lə.nɛn/
celynin k e - 'l @ - n i n /kɛ.'lə.nɪn/
cena 'k e - n a /'kɛ.na/
cena (foreign) 'k e - n a /'kɛ.na/
cendros 'k e n - d r o s /'kɛn.drɔs/
ceneaid (foreign) k e - n e - ai d /kɛ.nɛ.aɪd/
cenedlaeth k e - 'n e d - l aay th /kɛ.'nɛd.lɑɨθ/
cenel (foreign) 'k e - n e l /'kɛ.nɛl/
cerddad (foreign) 'k e r - dh a d /'kɛr.ðad/
cerddwriaeth k e r - 'dh u r - j aay th /kɛr.'ðʊr.jɑɨθ/
cered 'k e - r e d /'kɛ.rɛd/
ceredig k e - 'r ee - d i g /kɛ.'rɛː.dɪg/
cerrigelltgwm k e - r i - 'g e lh t - g u m /kɛ.rɪ.'gɛɬt.gʊm/
certmon (foreign) 'k e r t - m o n /'kɛrt.mɔn/
cesarea k e - s a - 'r e - a /kɛ.sa.'rɛ.a/
cesus (foreign) 'k ee - s y s /'kɛː.sɨs/
cesyg 'k ee - s y g /'kɛː.sɨg/
cf k v /kv/
cgag 'k g aa g /'kgaːg/
cgs s ii - jh ii - 'e s /sɪː.dʒɪː.'ɛs/
ch x /χ/
ch (nmcy) 'e x /'ɛχ/
chaffis 'x aa - f i s /'χaː.fɪs/
chalker 'x a l - k e r /'χal.kɛr/
chandra 'ch a n - d r a /'tʃan.dra/
chaniatad x a n - 'j a - t a d /χan.'ja.tad/
chappell 'x a - p e lh /'χa.pɛɬ/
chardin 'x a r - d i n /'χar.dɪn/
charitou x a - 'r i - 't o - y /χa.'rɪ.'tɔ.ɨ/
charnhuanawc x a r n - hh y - 'a - n au k /χarn.hɨ.'a.naʊk/
che 'x ee /'χɛː/
chernysh (foreign) 'x e r - n y sh /'χɛr.nɨʃ/
chiswell 'x i s - w e lh /'χɪs.wɛɬ/
chlorantha (foreign) x l o - 'r a n - th a /χlɔ.'ran.θa/
choy ch - 'oy /tʃ.'ɔɨ/
chr x r /χr/
chradoc 'x r aa - d o k /'χraː.dɔk/
chretien 'x r e t - j e n /'χrɛt.jɛn/
chryfach (foreign) 'x r @ - 'v aa x /'χrə.'vaːχ/
chwadal (foreign) 'x w aa - d a l /'χwaː.dal/
chwanag 'x w a - n a g /'χwa.nag/
chwanag (foreign) 'x w a - n a g /'χwa.nag/
chwara 'x w a - r a /'χwa.ra/
chwara (foreign) 'x w a - r a /'χwa.ra/
chwechyn (foreign) 'x w ee - x y n /'χwɛː.χɨn/
chwedyn 'x w ee - d y n /'χwɛː.dɨn/
chweochrog x w e - 'o x - r o g /χwɛ.'ɔχ.rɔg/
chwerwach 'x w e r - w a x /'χwɛr.waχ/
chwmniau 'x u m - n j ay /'χʊm.njaɨ/
chwn 'x u n /'χʊn/
chwylbro 'x uy l - b r o /'χʊɨl.brɔ/
chyddwyswyr x @ - 'dh uy - s uy r /χə.'ðʊɨ.sʊɨr/
chydig 'x @ - d i g /'χə.dɪg/
chydlynus x @ d - 'l @ - n y s /χəd.'lə.nɨs/
chynaladwy x @ - n a - 'l aa - d uy /χə.na.'laː.dʊɨ/
chystadleuthau x @ s - t a d - l ey - 'th ay /χəs.tad.ləɨ.'θaɨ/
chysylltnodydd x @ - s @ lh t - 'n oo - d @ dh /χə.səɬt.'nɔː.dəð/
chŵan 'x uu - a n /'χʊː.an/
cibl 'k ii - b i l /'kɪː.bɪl/
cica 's ii - k a /'sɪː.ka/
cicma s ii - ai - s ii - e - 'm ee /sɪː.aɪ.sɪː.ɛ.'mɛː/
cif 'k ii v /'kɪːv/
cif (foreign) 'k ii v /'kɪːv/
cilie 'k i l - j e /'kɪl.jɛ/
ciparolwg k i - p a - 'r o - l u g /kɪ.pa.'rɔ.lʊg/
ciparolygon k i - p a - r o - 'l @ - g o n /kɪ.pa.rɔ.'lə.gɔn/
cipris 'k i p - r i s /'kɪp.rɪs/
cirws 'k i - r u s /'kɪ.rʊs/
cirysau k i - 'r @ - s ay /kɪ.'rə.saɨ/
citigate 's i - t i - g ee t /'sɪ.tɪ.gɛːt/
citroën (foreign) 'k i t - r oy n /'kɪt.rɔɨn/
ciwba 'k iu - b a /'kɪʊ.ba/
claerwen 'k l aay r - w e n /'klɑɨr.wɛn/
clafr 'k l aa - v a r /'klaː.var/
clarisworks (foreign) k l a - 'r i s - w o r k s /kla.'rɪs.wɔrks/
clawdius (foreign) 'k l au d ii - @ s /'klaʊdɪː.əs/
clecs 'k l e k s /'klɛks/
cleientau k l e - 'j e n - t ay /klɛ.'jɛn.taɨ/
clercod 'k l e r - k o d /'klɛr.kɔd/
cliperi (foreign) k l i - 'p e - r i /klɪ.'pɛ.rɪ/
cliriach 'k l i r - j a x /'klɪr.jaχ/
clm k l m /klm/
clo\s 'k l o s /'klɔs/
closs 'k l o s /'klɔs/
clustan 'k l y s - t a n /'klɨs.tan/
clwbyn (foreign) 'k l uu - b y n /'klʊː.bɨn/
clwy 'k l uy /'klʊɨ/
clyweledol k l @ - w e - 'l ee - d o l /klə.wɛ.'lɛː.dɔl/
clïo 'k l i - o /'klɪ.ɔ/
cma s ii - e - 'm ee /sɪː.ɛ.'mɛː/
cmc s i - e m - 's ii /sɪ.ɛm.'sɪː/
cml s ii - e - 'm e l /sɪː.ɛ.'mɛl/
cmw e - k e - 'm uu /ɛ.kɛ.'mʊː/
cnafon 'k n aa - v o n /'knaː.vɔn/
cnebrwng 'k n e b - r u ng /'knɛb.rʊŋ/
cnecs (foreign) 'k n e k s /'knɛks/
cnofilod k n o - 'v i - l o d /knɔ.'vɪ.lɔd/
cobden 'k o b - d e n /'kɔb.dɛn/
cochyn 'k oo - x y n /'kɔː.χɨn/
cocpit (foreign) 'k o k - p i t /'kɔk.pɪt/
coe s ii - oo - 'ii /sɪː.ɔː.'ɪː/
coedybryn k oy - 'd @ b - r y n /kɔɨ.'dəb.rɨn/
coesa 'k oy - s a /'kɔɨ.sa/
coetsmon 'k oy t - s m o n /'kɔɨt.smɔn/
cofebau k o - 'v ee - b ay /kɔ.'vɛː.baɨ/
cofis 'k oo - v i s /'kɔː.vɪs/
coirib 'k oi - r i b /'kɔɪ.rɪb/
coitsmon 'k oi t - s m o n /'kɔɪt.smɔn/
cojimar k o - 'jh i - m a r /kɔ.'dʒɪ.mar/
coliars (foreign) 'k o l - j a r s /'kɔl.jars/
collett 'k o - lh e t /'kɔ.ɬɛt/
com s ii - oo - 'e m /sɪː.ɔː.'ɛm/
comex 'k o - m e k s /'kɔ.mɛks/
compendiwm k o m - 'p e n - d iu m /kɔm.'pɛn.dɪʊm/
compiwtar (foreign) k o m - 'p iu - t a r /kɔm.'pɪʊ.tar/
compownd (foreign) 'k o m - p ou n d /'kɔm.pəʊnd/
computacentre k @ m - p iu - t @ - 's e n - t @ /kəm.pɪʊ.tə.'sɛn.tə/
connery k o - 'n e - r y /kɔ.'nɛ.rɨ/
connolly k o - 'n o - lh y /kɔ.'nɔ.ɬɨ/
connop 'k o - n o p /'kɔ.nɔp/
consorci k o n - 's o r - k i /kɔn.'sɔr.kɪ/
contractiwr k o n - 't r a k - t iu r /kɔn.'trak.tɪʊr/
copaon k o - 'p a - o n /kɔ.'pa.ɔn/
copiau 'k o p - j ay /'kɔp.jaɨ/
copor (foreign) 'k o - p o r /'kɔ.pɔr/
copsey 'k o p - s ey /'kɔp.səɨ/
coraniaid k o - 'r a n - j ai d /kɔ.'ran.jaɪd/
corinthiaid k o - 'r i n - th j ai d /kɔ.'rɪn.θjaɪd/
corph (foreign) 'k o r f /'kɔrf/
cortegiano (foreign) k o r - t e g - 'j a - n o /kɔr.tɛg.'ja.nɔ/
coshh 'k o sh /'kɔʃ/
cosmopolitanaidd k o s - m o - p o - l i - 't a - n ai dh /kɔs.mɔ.pɔ.lɪ.'ta.naɪð/
cottam 'k o - t @ m /'kɔ.təm/
cowbridge k ou b - 'r i d - g e /kəʊb.'rɪd.gɛ/
cowhouse (foreign) k 'au hh 'au s /k'aʊh'aʊs/
cowt (foreign) 'k ou t /'kəʊt/
cp e k - 'p ii /ɛk.'pɪː/
cpm s ii - p ii - 'e m /sɪː.pɪː.'ɛm/
cpve s ii - p ii - v ii - 'ii /sɪː.pɪː.vɪː.'ɪː/
cr s ii - 'aa r /sɪː.'aːr/
cr/lf s ii - aa - r e - 'l e f /sɪː.aː.rɛ.'lɛf/
crackner-davies 'k r a k - n e r - 'd ei - v ii z /'krak.nɛr.'dəɪ.vɪːz/
cracyr 'k r a - k y r /'kra.kɨr/
cradoc 'k r aa - d o k /'kraː.dɔk/
cranwell 'k r a n - w e lh /'kran.wɛɬ/
cratiau 'k r a t - j ay /'krat.jaɨ/
crefyddus k r e - 'v @ - dh y s /krɛ.'və.ðɨs/
cregin 'k r ee - g i n /'krɛː.gɪn/
cremlin 'k r e m - l i n /'krɛm.lɪn/
creu'r 'k r ey r /'krəɨr/
crewyd 'k r e - w y d /'krɛ.wɨd/
crile 'k r i - l e /'krɪ.lɛ/
cripil (foreign) 'k r i - p i l /'krɪ.pɪl/
crispin 'k r i s - p i n /'krɪs.pɪn/
croatiaid k r o - 'a t - j ai d /krɔ.'at.jaɪd/
crocodil (foreign) k r o - 'k oo - d i l /krɔ.'kɔː.dɪl/
croesdoriad k r oy s - 't o r - j a d /krɔɨs.'tɔr.jad/
croesdynnu k r oy s - 't @ - n y /krɔɨs.'tə.nɨ/
croesnewydd 'k r oy s - 'n e - w y dh /'krɔɨs.'nɛ.wɨð/
croffte 'k r o f - t e /'krɔf.tɛ/
crogbris 'k r o g - b r i s /'krɔg.brɪs/
cromwelaidd k r o m - 'w e - l ai dh /krɔm.'wɛ.laɪð/
croniclwr k r o - 'n i k - l u r /krɔ.'nɪk.lʊr/
crossland 'k r o s - l a n d /'krɔs.land/
crosville (foreign) k r o s - 'v i - lh e /krɔs.'vɪ.ɬɛ/
croucher 'k r oy - x e r /'krɔɨ.χɛr/
crowrach 'k r ou - r a x /'krəʊ.raχ/
crwbanod k r u - 'b a - n o d /krʊ.'ba.nɔd/
cryfach 'k r @ - v a x /'krə.vaχ/
cryfaf 'k r @ - v a v /'krə.vav/
cryfaf (foreign) 'k r @ - v a v /'krə.vav/
cryfed 'k r @ - v e d /'krə.vɛd/
crêd 'k r ee d /'krɛːd/
csac s ii - e - s ee - 's ii /sɪː.ɛ.sɛː.'sɪː/
csca e - k e - s e - 'k aa /ɛ.kɛ.sɛ.'kaː/
cscs s ii - e s - s ii - 'e s /sɪː.ɛs.sɪː.'ɛs/
csf s ii - e - 's e f /sɪː.ɛ.'sɛf/
csh s ii - e - 's ai ch /sɪː.ɛ.'saɪtʃ/
ct s ii - 't ii /sɪː.'tɪː/
ctc s ii - t ii - 's ii /sɪː.tɪː.'sɪː/
ctt s ii - t ii - 't ii /sɪː.tɪː.'tɪː/
cubaniaid k y - 'b a n - j ai d /kɨ.'ban.jaɪd/
cubano (foreign) k y - 'b a - n o /kɨ.'ba.nɔ/
culach 'k y - l a x /'kɨ.laχ/
culheol k y l - 'hh e - o l /kɨl.'hɛ.ɔl/
cullmann 'k y lh - m a n /'kɨɬ.man/
cunliffe 'k @ n - l i f /'kən.lɪf/
cuthbert 'k y th - b e r t /'kɨθ.bɛrt/
cwangos (foreign) 'k w a ng - g o s /'kwaŋ.gɔs/
cwblhau'r k u b - 'l hh ay r /kʊb.'lhaɨr/
cwbwl 'k uu - b u l /'kʊː.bʊl/
cwc 'k u k /'kʊk/
cwci 'k u - k i /'kʊ.kɪ/
cwcis 'k u - k i s /'kʊ.kɪs/
cweit (foreign) 'k w ei t /'kwəɪt/
cwel 'k w e l /'kwɛl/
cwffra 'k u f - r a /'kʊf.ra/
cwm- 'k u m /'kʊm/
cwmardy k u - 'm a r - d y /kʊ.'mar.dɨ/
cwmniau 'k u m - n j ay /'kʊm.njaɨ/
cwmpendiwm k u m - 'p e n - d iu m /kʊm.'pɛn.dɪʊm/
cwmstradllyn k u m s - 't r a d - lh y n /kʊms.'trad.ɬɨn/
cwmtawe 'k u m - 't a - w e /'kʊm.'ta.wɛ/
cwmtirmynach k u m - t i r - 'm @ - n a x /kʊm.tɪr.'mə.naχ/
cwmtydu k u m - 't @ - d y /kʊm.'tə.dɨ/
cwn 'k u n /'kʊn/
cwrdiaid (foreign) 'k u r - d j ai d /'kʊr.djaɪd/
cwrdistan k u r - 'd i s - t a n /kʊr.'dɪs.tan/
cwrsiau 'k u r - sh ay /'kʊr.ʃaɨ/
cwsc 'k u s k /'kʊsk/
cwshti (foreign) 'k u sh - t i /'kʊʃ.tɪ/
cyd-gymry 'k yy d - 'g @ m - r y /'kɨːd.'gəm.rɨ/
cydag 'k @ - d a g /'kə.dag/
cydlynus k @ d - 'l @ - n y s /kəd.'lə.nɨs/
cydnebydd k @ d - 'n ee - b y dh /kəd.'nɛː.bɨð/
cydolygyddion k @ - d o - l @ - 'g @ dh - j o n /kə.dɔ.lə.'gəð.jɔn/
cydraddoleb k @ d - r a - 'dh o - l e b /kəd.ra.'ðɔ.lɛb/
cyfadda k @ - 'v aa - dh a /kə.'vaː.ða/
cyfarfoddydd k @ - v a r - 'v oo - dh y dh /kə.var.'vɔː.ðɨð/
cyfeiliog k @ - 'v ei l - j o g /kə.'vəɪl.jɔg/
cyfeiriaduron k @ - v ei r - j a - 'd y - r o n /kə.vəɪr.ja.'dɨ.rɔn/
cyfeisteddfod k @ - v ei s - 't e dh - v o d /kə.vəɪs.'tɛð.vɔd/
cyfieithiwyd k @ v - 'j ei - 'th i - w y d /kəv.'jəɪ.'θɪ.wɨd/
cyfla (foreign) 'k @ v - l a /'kəv.la/
cyflawnach k @ v - 'l au - n a x /kəv.'laʊ.naχ/
cyflawni'r k @ v - 'l au - n i r /kəv.'laʊ.nɪr/
cyfleir 'k @ v - l ei r /'kəv.ləɪr/
cyflwyno'r k @ v - 'l uy - n o r /kəv.'lʊɨ.nɔr/
cyflymach k @ v - 'l @ - m a x /kəv.'lə.maχ/
cyflymach (foreign) k @ v - 'l @ - m a x /kəv.'lə.maχ/
cyfnitherod k @ v - n i - 'th e - r o d /kəv.nɪ.'θɛ.rɔd/
cyfoesedd k @ - 'v oy - s e dh /kə.'vɔɨ.sɛð/
cyfoethocaf k @ - v oy - 'th o - k a v /kə.vɔɨ.'θɔ.kav/
cyfrifen k @ v - 'r ii - v e n /kəv.'rɪː.vɛn/
cyfrifiaduron k @ v - r i v - j a - 'd y - r o n /kəv.rɪv.ja.'dɨ.rɔn/
cyfyngus k @ - 'v @ - ng y s /kə.'və.ŋɨs/
cyfystyron k @ - v @ s - 't @ - r o n /kə.vəs.'tə.rɔn/
cyg 'k yy g /'kɨːg/
cyhuddgar k @ - 'hh y dh - g a r /kə.'hɨð.gar/
cym 'k y m /'kɨm/
cym (foreign) 'k y m /'kɨm/
cymad 'k @ - m a d /'kə.mad/
cymc 'k y m k /'kɨmk/
cymerth 'k @ - m e r th /'kə.mɛrθ/
cymeryd k @ - 'm e - r y d /kə.'mɛ.rɨd/
cymh 'k y m hh /'kɨmh/
cymhedrol 'k @ m hh e d - r o l /'kəmhɛd.rɔl/
cymmrodorion (foreign) k @ m - r o - 'd o r - j o n /kəm.rɔ.'dɔr.jɔn/
cymog 'k @ - m o g /'kə.mɔg/
cymortha k @ - 'm o r - th a /kə.'mɔr.θa/
cymorthdal k @ - 'm o r th - d a l /kə.'mɔrθ.dal/
cymraeg-saesneg 'k @ m - r aay g - 's aay s - n e g /'kəm.rɑɨg.'sɑɨs.nɛg/
cymraegioedolion k @ m - r aay g - j oy - 'd o l - j o n /kəm.rɑɨg.jɔɨ.'dɔl.jɔn/
cymreiciaf k @ m - 'r ei k - j a v /kəm.'rəɪk.jav/
cymreigrwydd k @ m - 'r ei g - r uy dh /kəm.'rəɪg.rʊɨð/
cymreigyddion k @ m - r ei - 'g @ dh - j o n /kəm.rəɪ.'gəð.jɔn/
cymreigyddol k @ m - r ei - 'g @ - dh o l /kəm.rəɪ.'gə.ðɔl/
cymric (foreign) 'k @ m - r i k /'kəm.rɪk/
cymydol k @ - 'm @ - d o l /kə.'mə.dɔl/
cynaladwy k @ - n a - 'l aa - d uy /kə.na.'laː.dʊɨ/
cynaladwyaeth k @ - n a - 'l aa - 'd uy - aay th /kə.na.'laː.'dʊɨ.ɑɨθ/
cynddo (foreign) 'k @ n - dh o /'kən.ðɔ/
cynfyn 'k @ n - v y n /'kən.vɨn/
cyng 'k y ng /'kɨŋ/
cynhanesyddol k @ n hh a - n e - 's @ - dh o l /kənha.nɛ.'sə.ðɔl/
cynhyrchiadau k @ n hh @ r - 'x j aa - d ay /kənhər.'χjaː.daɨ/
cynllwyngar k @ n - 'lh uy - ng a r /kən.'ɬʊɨ.ŋar/
cynnach 'k @ - n a x /'kə.naχ/
cynnas 'k @ - n a s /'kə.nas/
cynnas (foreign) 'k @ - n a s /'kə.nas/
cynorthwy-ydd k @ - 'n o r - 'th uy - 'yy dh /kə.'nɔr.'θʊɨ.'ɨːð/
cyntafanedig k @ n - t a - v a - 'n ee - d i g /kən.ta.va.'nɛː.dɪg/
cynulleidfaoliaeth k @ - n y - lh ei d - v a - 'o l - j aay th /kə.nɨ.ɬəɪd.va.'ɔl.jɑɨθ/
cynulliedig k @ - n y lh - 'j ee - d i g /kə.nɨɬ.'jɛː.dɪg/
cynyr 'k @ - n @ r /'kə.nər/
cypriad (foreign) k @ p - r j a d /kəp.rjad/
cyrtan (foreign) 'k @ r - t a n /'kər.tan/
cysawdau k @ - 's au - d ay /kə.'saʊ.daɨ/
cystadleuthau k @ s - t a d - l ey - 'th ay /kəs.tad.ləɨ.'θaɨ/
cysyllte k @ - 's @ lh - t e /kə.'səɬ.tɛ/
cyt 'k y t /'kɨt/
cythrael (foreign) 'k @ th - r aay l /'kəθ.rɑɨl/
cythril 'k @ th - r i l /'kəθ.rɪl/
cytlasau k @ t - 'l aa - s ay /kət.'laː.saɨ/
cyweiriol k @ - 'w ei r - j o l /kə.'wəɪr.jɔl/
câl 'k aa l /'kaːl/
cïaidd 'k i - ai dh /'kɪ.aɪð/
côd 'k oo d /'kɔːd/
côdau 'k oo - d ay /'kɔː.daɨ/
côf 'k oo v /'kɔːv/
cŵys 'k uu - y s /'kʊː.ɨs/
d 'd ii /'dɪː/
d'dwch 'd @ - d u x /'də.dʊχ/
d'wed 'd w e d /'dwɛd/
d'wedodd 'd w e - d o dh /'dwɛ.dɔð/
d'wetha 'd w e - th a /'dwɛ.θa/
d'yn 'd y n /'dɨn/
d/l d ii - 'e l /dɪː.'ɛl/
d/y d ii - '@@ /dɪː.'ɜː/
daa d aa /daː/
dadzipio d a d - 'z i p - j o /dad.'zɪp.jɔ/
dafodrill d a - 'v o d - r i lh /da.'vɔd.rɪɬ/
dairieithog d ai r - 'j ei - th o g /daɪr.'jəɪ.θɔg/
dalach (foreign) 'd a - l a x /'da.laχ/
dalis (foreign) 'd a - l i s /'da.lɪs/
daloni d a - 'l o - n i /da.'lɔ.nɪ/
damia (foreign) 'd a m - j a /'dam.ja/
danddaear d a n - 'dh aay - a r /dan.'ðɑɨ.ar/
danial 'd a n - j a l /'dan.jal/
dannadd (foreign) 'd a - n a dh /'da.nað/
darganfyddwyd d a r - g a n - 'v @ - dh uy d /dar.gan.'və.ðʊɨd/
dargyfeirwyr d a r - g @ - 'v ei - r uy r /dar.gə.'vəɪ.rʊɨr/
darllenedd d a r - 'lh e - n e dh /dar.'ɬɛ.nɛð/
darnynol d a r - 'n @ - n o l /dar.'nə.nɔl/
daru (foreign) 'd a - r y /'da.rɨ/
databas (foreign) d a - 't aa - b a s /da.'taː.bas/
datblygu'r d a t - 'b l @ - g y r /dat.'blə.gɨr/
datgeinydd d a t - 'g ei - n y dh /dat.'gəɪ.nɨð/
datgomisiynu d a t - g o - m i - s i - '@ - n y /dat.gɔ.mɪ.sɪ.'ə.nɨ/
datini (foreign) d a - 't i - n i /da.'tɪ.nɪ/
datádatum d ee - t @ - 'd ee - t @ m /dɛː.tə.'dɛː.təm/
dauddiwylliannedd d ay - dh i - w @ lh - 'j a - n e dh /daɨ.ðɪ.wəɬ.'ja.nɛð/
daulythrennedd d ay - l @ th - 'r e - n e dh /daɨ.ləθ.'rɛ.nɛð/
daulythrennog d ay - l @ th - 'r e - n o g /daɨ.ləθ.'rɛ.nɔg/
davos 'd a - v o s /'da.vɔs/
daz (foreign) 'd a z /'daz/
dbrw d ii - b ii - aa r - 'd @ - b l iu /dɪː.bɪː.aːr.'də.blɪʊ/
dcf d ii - s ii - 'e f /dɪː.sɪː.'ɛf/
dcms d ii - s ii - e - 'm e s /dɪː.sɪː.ɛ.'mɛs/
dd 'e dh /'ɛð/
ddad-danysgrifio 'dh aa d - d a - n @ s - 'k r i v - j o /'ðaːd.da.nəs.'krɪv.jɔ/
ddaflen 'dh a v - l e n /'ðav.lɛn/
ddarganfyddwyd dh a r - g a n - 'v @ - dh uy d /ðar.gan.'və.ðʊɨd/
ddargyfeirwyr dh a r - g @ - 'v ei - r uy r /ðar.gə.'vəɪ.rʊɨr/
ddatblygu'r dh a t - 'b l @ - g y r /ðat.'blə.gɨr/
ddauddiwylliannedd dh ay - dh i - w @ lh - 'j a - n e dh /ðaɨ.ðɪ.wəɬ.'ja.nɛð/
ddauddiwylliannol dh ay - dh i - w @ lh - 'j a - n o l /ðaɨ.ðɪ.wəɬ.'ja.nɔl/
ddaulythrennog dh ay - l @ th - 'r e - n o g /ðaɨ.ləθ.'rɛ.nɔg/
ddechra 'dh e x - r a /'ðɛχ.ra/
ddechrau'r 'dh e x - r ay r /'ðɛχ.raɨr/
ddechre 'dh e x - r e /'ðɛχ.rɛ/
ddefnyddio'r dh e v - 'n @ dh - j o r /ðɛv.'nəð.jɔr/
dder (foreign) 'dh e r /'ðɛr/
ddeudist 'dh ey - d i s t /'ðəɨ.dɪst/
ddeudist (foreign) 'dh ey - d i s t /'ðəɨ.dɪst/
ddeuffonau dh ey f - 'o n - ay /ðəɨf.'ɔn.aɨ/
ddeutsoch (foreign) 'dh ey - ch o x /'ðəɨ.tʃɔχ/
ddiddychwelyd dh i - dh @ x - 'w e - l y d /ðɪ.ðəχ.'wɛ.lɨd/
ddileit (foreign) 'dh i - l ei t /'ðɪ.ləɪt/
ddios 'dh j oo s /'ðjɔːs/
ddiscresiwn (foreign) dh i s - 'k r ee - s iu n /ðɪs.'krɛː.sɪʊn/
ddiwaith 'dh i - w ai th /'ðɪ.waɪθ/
ddogau 'dh oo - g ay /'ðɔː.gaɨ/
ddois 'dh oi s /'ðɔɪs/
ddois (foreign) 'dh oi s /'ðɔɪs/
ddoist 'dh oi s t /'ðɔɪst/
ddoist (foreign) 'dh oi s t /'ðɔɪst/
ddwr 'dh u r /'ðʊr/
ddyfnach 'dh @ v - n a x /'ðəv.naχ/
ddyfrbont 'dh @ v - r b o n t /'ðəv.rbɔnt/
ddyliet 'dh @ l - j e t /'ðəl.jɛt/
ddyliwn 'dh @ - l iu n /'ðə.lɪʊn/
ddylsen (foreign) 'dh @ l - s e n /'ðəl.sɛn/
ddylunwraig dh @ - 'l y n - rw ai g /ðə.'lɨn.rwaɪg/
ddynas (foreign) 'dh @ - n a s /'ðə.nas/
ddysgu'r 'dh @ s - k y r /'ðəs.kɨr/
ddês (foreign) 'dh ee s /'ðɛːs/
debenhams 'd e - b @ - n @ m z /'dɛ.bə.nəmz/
debora d e - 'b o - r a /dɛ.'bɔ.ra/
debycach d e - 'b @ - k a x /dɛ.'bə.kaχ/
dechra 'd e x - r a /'dɛχ.ra/
dechra (foreign) 'd e x - r a /'dɛχ.ra/
dechrau'r 'd e x - r ay r /'dɛχ.raɨr/
dechre 'd e x - r e /'dɛχ.rɛ/
dechre (foreign) 'd e x - r e /'dɛχ.rɛ/
decpunt (foreign) 'd e k - p y n t /'dɛk.pɨnt/
ded (foreign) 'd ee d /'dɛːd/
deffroais d e f - 'r o - ai s /dɛf.'rɔ.aɪs/
deffrôdd d e f - 'r oo dh /dɛf.'rɔːð/
defi 'd ee - v i /'dɛː.vɪ/
defnyddio'r d e v - 'n @ dh - j o r /dɛv.'nəð.jɔr/
defonaidd d e - 'v o - n ai dh /dɛ.'vɔ.naɪð/
deiacronig d e - j a k - 'r o - n i g /dɛ.jak.'rɔ.nɪg/
deiagramau d e - j a g - 'r a - m ay /dɛ.jag.'ra.maɨ/
deiars (foreign) 'd e - j a r s /'dɛ.jars/
deilwen 'd ei l - w e n /'dəɪl.wɛn/
deimlo'n 'd ei m - l o n /'dəɪm.lɔn/
deinasoriaid d ei - n a - 's o r - j ai d /dəɪ.na.'sɔr.jaɪd/
deinosoriaid d ei - n o - 's o r - j ai d /dəɪ.nɔ.'sɔr.jaɪd/
deintyddfa d ei n - 't @ dh - v a /dəɪn.'təð.va/
deirawr (foreign) 'd ei - r au r /'dəɪ.raʊr/
deirieithog d ei r - 'j ei - th o g /dəɪr.'jəɪ.θɔg/
deirieithrwydd d ei r - 'j ei th - r uy dh /dəɪr.'jəɪθ.rʊɨð/
deirpig (foreign) 'd ei r - p i g /'dəɪr.pɪg/
delaf 'd e - l a v /'dɛ.lav/
delicet (foreign) d e - 'l i - k e t /dɛ.'lɪ.kɛt/
delme 'd e l m /'dɛlm/
deloittes d i - 'l oi t s /dɪ.'lɔɪts/
delwyn 'd e - l uy n /'dɛ.lʊɨn/
demiwrg (foreign) 'd e - m iu r g /'dɛ.mɪʊrg/
dengmlwyddiant d e ng - 'm l uy dh - j a n t /dɛŋ.'mlʊɨð.jant/
dennison 'd e - n i - s @ n /'dɛ.nɪ.sən/
densil 'd e n - s i l /'dɛn.sɪl/
deo d ii - ii - 'oo /dɪː.ɪː.'ɔː/
der (foreign) 'd e r /'dɛr/
derbe (foreign) d e r - 'b e /dɛr.'bɛ/
derier (foreign) 'd e r - j e r /'dɛr.jɛr/
deuben 'd ey - b e n /'dəɨ.bɛn/
deudraeth 'd ey d - r aay th /'dəɨd.rɑɨθ/
deued 'd ey - e d /'dəɨ.ɛd/
deued (foreign) 'd ey - e d /'dəɨ.ɛd/
deufalfiaid d ey - 'v a l - v j ai d /dəɨ.'val.vjaɪd/
deuffon 'd ey f - o n /'dəɨf.ɔn/
deufiniog d ey - 'v i n - j o g /dəɨ.'vɪn.jɔg/
deum (foreign) 'd ey m /'dəɨm/
deunawiaid d ey - 'n au - j ai d /dəɨ.'naʊ.jaɪd/
deut 'd ey t /'dəɨt/
devereux d e - 'v e - r ey k s /dɛ.'vɛ.rəɨks/
dewinol d e - 'w i - n o l /dɛ.'wɪ.nɔl/
dewisiol d e - 'w i - sh o l /dɛ.'wɪ.ʃɔl/
dewraf 'd eu - r a v /'dɛʊ.rav/
deëllir d e - 'e - lh i r /dɛ.'ɛ.ɬɪr/
deô (foreign) d e - 'oo /dɛ.'ɔː/
dfs d ii - e - 'f e s /dɪː.ɛ.'fɛs/
dha d ii - ee - 'ch ee /dɪː.ɛː.'tʃɛː/
di-stwr 'd ii s - 't u r /'dɪːs.'tʊr/
diaddysg 'd j aa - dh y s k /'djaː.ðɨsk/
diaist (foreign) 'd j ai s t /'djaɪst/
diamwnt 'd j a - m u n t /'dja.mʊnt/
diamwntau 'd j a - 'm u n - t ay /'dja.'mʊn.taɨ/
dian (foreign) 'd j a n /'djan/
diar (foreign) 'd j a r /'djar/
diawch (foreign) 'd j au x /'djaʊχ/
diawlad 'd j au - l a d /'djaʊ.lad/
dibaid 'd ii - b ai d /'dɪː.baɪd/
dicâu d i - 'k aa - y /dɪ.'kaː.ɨ/
didor 'd ii - d o r /'dɪː.dɔr/
diek 'd j e k /'djɛk/
dienwad 'd j e n - w a d /'djɛn.wad/
diferynion d i - v e - 'r @ n - j o n /dɪ.vɛ.'rən.jɔn/
diffynydd d i - 'f @ - n y dh /dɪ.'fə.nɨð/
difrio 'd i v - r j o /'dɪv.rjɔ/
diglossia (foreign) d i g - 'l o s - j a /dɪg.'lɔs.ja/
digrifaf d i g - 'r ii - v a v /dɪg.'rɪː.vav/
digwestiwn d i g - 'w e s - t iu n /dɪg.'wɛs.tɪʊn/
digwyddiadur d i - g uy dh - 'j aa - d y r /dɪ.gʊɨð.'jaː.dɨr/
digymrodedd d i - g @ m - 'r oo - d e dh /dɪ.gəm.'rɔː.dɛð/
digynnyrch (foreign) d i - 'g @ - n y r x /dɪ.'gə.nɨrχ/
dihewid d i - 'hh e - w i d /dɪ.'hɛ.wɪd/
dihiwmor d i - 'hh iu - m o r /dɪ.'hɪʊ.mɔr/
dik 'd i k /'dɪk/
dilema (foreign) d i - 'l e - m a /dɪ.'lɛ.ma/
dilewyd d i - 'l e - w y d /dɪ.'lɛ.wɨd/
dima 'd i - m a /'dɪ.ma/
dimm 'd i m /'dɪm/
dinogad d i - 'n oo - g a d /dɪ.'nɔː.gad/
diogelach d j o - 'g e - l a x /djɔ.'gɛ.laχ/
diogeledd d j o - 'g e - l e dh /djɔ.'gɛ.lɛð/
diplomatyddiaeth d i p - l o - m a - 't @ dh - j aay th /dɪp.lɔ.ma.'təð.jɑɨθ/
diraen 'd i - r aay n /'dɪ.rɑɨn/
directgov d ai - 'r e k t - g o v /daɪ.'rɛkt.gɔv/
dirfeddiannol (foreign) 'd i r - v e dh - 'j a - n o l /'dɪr.vɛð.'ja.nɔl/
disail 'd ii - s ai l /'dɪː.saɪl/
disgos (foreign) 'd i s - k o s /'dɪs.kɔs/
disgwl 'd i s - k u l /'dɪs.kʊl/
disgwl (foreign) 'd i s - k u l /'dɪs.kʊl/
disgynyddiaeth d i s - k @ - 'n @ dh - j aay th /dɪs.kə.'nəð.jɑɨθ/
dithe 'd ii - th e /'dɪː.θɛ/
diwadd (foreign) 'd i - w a dh /'dɪ.wað/
diwaith 'd i - w ai th /'dɪ.waɪθ/
dlos 'd l oo s /'dlɔːs/
dml d i - e - 'm e l /dɪ.ɛ.'mɛl/
doby 'd oo - b y /'dɔː.bɨ/
docie 'd o k - j e /'dɔk.jɛ/
doeddan 'd oy - dh a n /'dɔɨ.ðan/
doeddan (foreign) 'd oy - dh a n /'dɔɨ.ðan/
doeddyn 'd oy - dh y n /'dɔɨ.ðɨn/
doethach 'd oy - th a x /'dɔɨ.θaχ/
dogau 'd oo - g ay /'dɔː.gaɨ/
doherty d o - 'hh e r - t y /dɔ.'hɛr.tɨ/
dois 'd oi s /'dɔɪs/
dolig 'd o - l i g /'dɔ.lɪg/
dominos (foreign) d o - 'm i - n o s /dɔ.'mɪ.nɔs/
dominôs (foreign) d o - m i - 'n oo s /dɔ.mɪ.'nɔːs/
doorshis (foreign) d 'oo r - sh @ s /d'ɔːr.ʃəs/
dorts (foreign) 'd o r t s /'dɔrts/
dostoiefsci d o s - t o - 'j e v - s k i /dɔs.tɔ.'jɛv.skɪ/
dotiedig d o t - 'j ee - d i g /dɔt.'jɛː.dɪg/
dottie 'd o t - j e /'dɔt.jɛ/
dowdle 'd ou d - l e /'dəʊd.lɛ/
dowell 'd o - w e lh /'dɔ.wɛɬ/
dowlad (foreign) 'd ou - l a d /'dəʊ.lad/
dpc d ii - p ii - 's ii /dɪː.pɪː.'sɪː/
drafflith 'd r a f - l i th /'draf.lɪθ/
dralin (foreign) 'd r a - l i n /'dra.lɪn/
dramau 'd r a - m ay /'dra.maɨ/
drayton 'd r ai - t @ n /'draɪ.tən/
dreifar (foreign) 'd r ei - v a r /'drəɪ.var/
dreifwyr 'd r ei - v uy r /'drəɪ.vʊɨr/
dremddu 'd r e m - dh y /'drɛm.ðɨ/
drezen 'd r e - z e n /'drɛ.zɛn/
drom 'd r o m /'drɔm/
drom (foreign) d r o m /drɔm/
droog 'd r uu g /'drʊːg/
dror (foreign) 'd r o r /'drɔr/
drorau 'd r o - r ay /'drɔ.raɨ/
drostoch d r o s - t o x /drɔs.tɔχ/
droston d r o s - t o n /drɔs.tɔn/
drostot d r o s - t o t /drɔs.tɔt/
druce 'd r y - k e /'drɨ.kɛ/
drutaf 'd r y - t a v /'drɨ.tav/
drw 'd r uu /'drʊː/
drwgenwog d r u - 'g e n - w o g /drʊ.'gɛn.wɔg/
drwy'r d r uy r /drʊɨr/
drwyddoch d r uy - dh o x /drʊɨ.ðɔχ/
drwyddon d r uy - dh o n /drʊɨ.ðɔn/
drwyddot (foreign) d r uy - dh o t /drʊɨ.ðɔt/
drychfilod d r @ x - 'v i - l o d /drəχ.'vɪ.lɔd/
dryhurst 'd r @ - hh y r s t /'drə.hɨrst/
drymach 'd r @ - m a x /'drə.maχ/
dsm d ii - e - 's e m /dɪː.ɛ.'sɛm/
dteangacha t ii n - 'g a - x a /tɪːn.'ga.χa/
dti d ii - t ii - 'ai /dɪː.tɪː.'aɪ/
dumville (foreign) d '@ m - - v i l /d'əm..vɪl/
dunawd 'd y - n au d /'dɨ.naʊd/
dunlop 'd y n - l o p /'dɨn.lɔp/
durrboden d y r - 'b oo - d e n /dɨr.'bɔː.dɛn/
duwcs (foreign) 'd yu k s /'dɨʊks/
dvla d ii - v ii - e - 'l ei /dɪː.vɪː.ɛ.'ləɪ/
dwad d w a d /dwad/
dwblwr 'd u b - l u r /'dʊb.lʊr/
dwbwl 'd uu - b u l /'dʊː.bʊl/
dwbwl (foreign) 'd uu - b u l /'dʊː.bʊl/
dwhowell (foreign) d w hh 'au - @ l /dwh'aʊ.əl/
dwi'n d ui n /dʊɪn/
dwnn 'd u n /'dʊn/
dwyau 'd ay /'daɨ/
dwyawr 'd uy - au r /'dʊɨ.aʊr/
dwyblaid 'd uy b - l ai d /'dʊɨb.laɪd/
dwyf 'd uy v /'dʊɨv/
dwysach 'd uy - s a x /'dʊɨ.saχ/
dwytha 'd uy - th a /'dʊɨ.θa/
dwytha (foreign) 'd uy - th a /'dʊɨ.θa/
dybenion (foreign) d @ - 'b e n - j o n /də.'bɛn.jɔn/
dydan (foreign) 'd @ - d a n /'də.dan/
dyddiaduron d @ dh - j a - 'd y - r o n /dəð.ja.'dɨ.rɔn/
dyddie 'd @ dh - j e /'dəð.jɛ/
dyden 'd @ - d e n /'də.dɛn/
dyden (foreign) 'd @ - d e n /'də.dɛn/
dydy'r d @ - d y r /də.dɨr/
dyfarnydd d @ - 'v a r - n @ dh /də.'var.nəð/
dyffrynoedd d @ f - 'r @ - n oy dh /dəf.'rə.nɔɨð/
dyfnach 'd @ v - n a x /'dəv.naχ/
dyfrbont 'd @ v - r b o n t /'dəv.rbɔnt/
dyfrliw 'd @ v r - l iu /'dəvr.lɪʊ/
dylai'r d @ - 'l aa i r /də.'laːɪr/
dynas 'd @ - n a s /'də.nas/
dynein 'd @ - n ei n /'də.nəɪn/
dynnach 'd @ - n a x /'də.naχ/
dyodiad (foreign) d @ - 'o d - j a d /də.'ɔd.jad/
dyranwyd d @ - 'r a - n uy d /də.'ra.nʊɨd/
dyscawdwyr (foreign) d @ s - 'k au - d uy r /dəs.'kaʊ.dʊɨr/
dysgawdwr d @ s - 'k au - d u r /dəs.'kaʊ.dʊr/
dysgawdwyr d @ s - 'k au - d uy r /dəs.'kaʊ.dʊɨr/
dysgu'r 'd @ s - k y r /'dəs.kɨr/
dysgwyl 'd @ s - k uy l /'dəs.kʊɨl/
dystar (foreign) 'd @ s - t a r /'dəs.tar/
dywaid 'd @ - w ai d /'də.waɪd/
déja 'd ei - zh a /'dəɪ.ʒa/
dôs (foreign) 'd oo s /'dɔːs/
dŵf (foreign) 'd uu v /'dʊːv/
dŷch 'd yy x /'dɨːχ/
e'n 'e n /'ɛn/
eames e - 'a - m e s /ɛ.'a.mɛs/
eardley-wilmot (foreign) '@r - d @ l ii - w i l - m @ t /'ər.dəlɪː.wɪl.mət/
ebenezer e - b e - 'n e - z e r /ɛ.bɛ.'nɛ.zɛr/
eblul 'e b - l y l /'ɛb.lɨl/
ebostio ee - 'b o s - t j o /ɛː.'bɔs.tjɔ/
ebostiwch e - 'b o s - t iu x /ɛ.'bɔs.tɪʊχ/
ecards 'ii - k aa d z /'ɪː.kaːdz/
eckert 'e - k e r t /'ɛ.kɛrt/
economwyr e - k o - 'n o - m uy r /ɛ.kɔ.'nɔ.mʊɨr/
ecsodus e k - 's oo - d y s /ɛk.'sɔː.dɨs/
ecstra (foreign) 'e k s - t r a /'ɛks.tra/
ecstract (foreign) 'e k s - t r a k t /'ɛks.trakt/
ecstracts (foreign) 'e k s - t r a k t s /'ɛks.trakts/
ecstras (foreign) 'e k s - t r a s /'ɛks.tras/
edelman 'ee - d @ l - m @ n /'ɛː.dəl.mən/
edgair 'e d - g ai r /'ɛd.gaɪr/
edmond 'e d - m o n d /'ɛd.mɔnd/
edrach (foreign) 'e d - r a x /'ɛd.raχ/
edword 'e d - w @@ d /'ɛd.wɜːd/
eee ii - e /ɪː.ɛ/
effeithioldeb e - f ei th - 'j o l - d e b /ɛ.fəɪθ.'jɔl.dɛb/
effemeral e - f e - 'm e - r a l /ɛ.fɛ.'mɛ.ral/
effesiaid (foreign) e - f e - sh ai d /ɛ.fɛ.ʃaɪd/
effesus (foreign) e - f e - s y s /ɛ.fɛ.sɨs/
efff 'e f /'ɛf/
effod (foreign) e - 'f o d /ɛ.'fɔd/
effraim (foreign) i - f r 'ei m /ɪ.fr'əɪm/
efnysien e v - 'n @ - sh e n /ɛv.'nə.ʃɛn/
eg 'ii - jh ii /'ɪː.dʒɪː/
egar 'ee - g a r /'ɛː.gar/
egardiau e - 'g a r - d j ay /ɛ.'gar.djaɨ/
ei'n 'ei n /'əɪn/
eingl-americanaidd 'ei - ng i - l a - m e - r i - 'k a - n ai dh /'əɪ.ŋɪ.la.mɛ.rɪ.'ka.naɪð/
eingl-gymraeg 'ei - ng i l - 'g @ m - r aay g /'əɪ.ŋɪl.'gəm.rɑɨg/
eiriaduron ei r - j a - 'd y - r o n /əɪr.ja.'dɨ.rɔn/
eiryl 'ei - r y l /'əɪ.rɨl/
eisie 'ei - sh e /'əɪ.ʃɛ/
eisie (foreign) 'ei - sh e /'əɪ.ʃɛ/
eivissa (foreign) ei - 'v i - s a /əɪ.'vɪ.sa/
ek 'e k /'ɛk/
elcana'n (foreign) 'e l - k a n 'a n /'ɛl.kan'an/
eleazar e - l e - 'a - z a r /ɛ.lɛ.'a.zar/
elenor e - 'l e - n o r /ɛ.'lɛ.nɔr/
elfennaidd e l - 'v e - n ai dh /ɛl.'vɛ.naɪð/
elfennaidd (foreign) e l - 'v e - n ai dh /ɛl.'vɛ.naɪð/
eliab (foreign) i - l 'ai - @ - b /ɪ.l'aɪ.ə.b/
eliada (foreign) e - 'l j aa - d a /ɛ.'ljaː.da/
eliasar e l - 'j aa - s a r /ɛl.'jaː.sar/
eliffantod e - l i - 'f a n - t o d /ɛ.lɪ.'fan.tɔd/
eliffelet (foreign) e - 'l ii - f - l @ t /ɛ.'lɪː.f.lət/
elihu e - 'l i - hh y /ɛ.'lɪ.hɨ/
elis- 'e - l i s /'ɛ.lɪs/
elis-thomas e - l i s - 't o - m @ s /ɛ.lɪs.'tɔ.məs/
elisama (foreign) i - l 'i - z @ - m 'o /ɪ.l'ɪ.zə.m'ɔ/
elisua (foreign) e - l i - s 'uu - @ /ɛ.lɪ.s'ʊː.ə/
ellyllon e - 'lh @ - lh o n /ɛ.'ɬə.ɬɔn/
elvet 'e l - v e t /'ɛl.vɛt/
elystan e - 'l @ s - t a n /ɛ.'ləs.tan/
emli 'e m - l i /'ɛm.lɪ/
emmerton e - 'm e r - t o n /ɛ.'mɛr.tɔn/
empathetig e m - p a - 'th e - t i g /ɛm.pa.'θɛ.tɪg/
empre 'e m - p r e /'ɛm.prɛ/
eneiniedig e - n ei n - 'j ee - d i g /ɛ.nəɪn.'jɛː.dɪg/
enethod e - 'n ee - th o d /ɛ.'nɛː.θɔd/
enforeced (foreign) e n - f 'oo r - k e d /ɛn.f'ɔːr.kɛd/
eng ii - e n - 'jh ii /ɪː.ɛn.'dʒɪː/
engadin e - 'ng aa - d i n /ɛ.'ŋaː.dɪn/
ennillodd e - 'n i - lh o dh /ɛ.'nɪ.ɬɔð/
enoc 'e - n o k /'ɛ.nɔk/
enomeris e - n o - 'm e - r i s /ɛ.nɔ.'mɛ.rɪs/
enseiclopidia (foreign) e n - s ei k - l o - 'p i d - j a /ɛn.səɪk.lɔ.'pɪd.ja/
ensslin 'e n s - l i n /'ɛns.lɪn/
entrepreneuraidd o n - t r @ p - r @ - 'n @@ - r ai dh /ɔn.trəp.rə.'nɜː.raɪð/
enw'r e n - 'w r /ɛn.'wr/
enwocach e n - 'w o - k a x /ɛn.'wɔ.kaχ/
enwocaf e n - 'w o - k a v /ɛn.'wɔ.kav/
enwoced e n - 'w o - k e d /ɛn.'wɔ.kɛd/
eproth 'e p - r o th /'ɛp.rɔθ/
epu ii - p ii - 'iu /ɪː.pɪː.'ɪʊ/
erbery e r - 'b e - r y /ɛr.'bɛ.rɨ/
erbin 'e r - b i n /'ɛr.bɪn/
eresbury e - r e s - 'p y - r y /ɛ.rɛs.'pɨ.rɨ/
erging 'e r - g i ng /'ɛr.gɪŋ/
erlas 'e r - l a s /'ɛr.las/
erlynwyr e r - 'l @ - n uy r /ɛr.'lə.nʊɨr/
eryrod e - 'r @ - r o d /ɛ.'rə.rɔd/
eryrod (foreign) e - 'r @ - r o d /ɛ.'rə.rɔd/
esbonio'r e s - 'p o n - j o r /ɛs.'pɔn.jɔr/
eschatolegol e s - x a - t o - 'l ee - g o l /ɛs.χa.tɔ.'lɛː.gɔl/
esclusham e s - 'k l y - sh a m /ɛs.'klɨ.ʃam/
esgyrniog e s - 'k @ r - n j o g /ɛs.'kər.njɔg/
esmwythach e s - 'm uy - th a x /ɛs.'mʊɨ.θaχ/
esop 'ee - s o p /'ɛː.sɔp/
esoterig e - s o - 't e - r i g /ɛ.sɔ.'tɛ.rɪg/
esqre 'e s - rw e /'ɛs.rwɛ/
etang (foreign) 'e - t a ng /'ɛ.taŋ/
etc 'e t k /'ɛtk/
etc (adv) e t - 's e t - r @ /ɛt.'sɛt.rə/
etc (foreign) 'e t k /'ɛtk/
ethiop 'e th - j o p /'ɛθ.jɔp/
ethiopiaid (foreign) e th - 'j o p - j ai d /ɛθ.'jɔp.jaɪd/
euroway iu - r @ - w ei /ɪʊ.rə.wəɪ/
eurwyn 'ey - r uy n /'əɨ.rʊɨn/
eutychus (foreign) 'ey - @ - x y s /'əɨ.ə.χɨs/
evas 'e - v a s /'ɛ.vas/
evita e - 'v i - t a /ɛ.'vɪ.ta/
ew (foreign) 'eu /'ɛʊ/
ewffrates (foreign) j uu - f r 'ei t s /jʊː.fr'əɪts/
ewias 'eu - j a s /'ɛʊ.jas/
ewrob 'eu - r o b /'ɛʊ.rɔb/
ewythrod e - 'w @ th - r o d /ɛ.'wəθ.rɔd/
expence (foreign) 'e k - s p @ n s /'ɛk.spəns/
eyn (foreign) 'ey n /'əɨn/
f 'e f /'ɛf/
f (nmcy) 'e v /'ɛv/
f'unig 'v y - n i g /'vɨ.nɪg/
fabanod v a - 'b a - n o d /va.'ba.nɔd/
fabilon (foreign) 'v aa - b i - l o n /'vaː.bɪ.lɔn/
fabwysiadwr v a - 'b uy - 'sh aa - d u r /va.'bʊɨ.'ʃaː.dʊr/
faech v aay x /vɑɨχ/
faelfa (foreign) 'v aay l - v a /'vɑɨl.va/
faelon 'v aay - l o n /'vɑɨ.lɔn/
faet v aay t /vɑɨt/
falkus 'v a l - k y s /'val.kɨs/
falŵns v a - 'l uu n s /va.'lʊːns/
fanco (foreign) 'v a ng - k o /'vaŋ.kɔ/
fanwerthwr v a n - 'w e r - th u r /van.'wɛr.θʊr/
fanwerthwyr v a n - 'w e r - th uy r /van.'wɛr.θʊɨr/
fanylach v a - 'n @ - l a x /va.'nə.laχ/
fao e - f ee - 'oo /ɛ.fɛː.'ɔː/
farchwel (foreign) v a r - 'x w e l /var.'χwɛl/
farnham 'v a r n - hh a m /'varn.ham/
farringdon 'f a - r i ng - d @ n /'fa.rɪŋ.dən/
farsus (foreign) 'v a r - s y s /'var.sɨs/
fasai v a - s ai /va.saɪ/
fasan (foreign) 'v aa - s a n /'vaː.san/
fatris (foreign) 'v a t - r i s /'vat.rɪs/
fawsley 'v au s - l ey /'vaʊs.ləɨ/
fayrefield 'f ee - @ - f ii l d /'fɛː.ə.fɪːld/
fechan 'v ee - x a n /'vɛː.χan/
fechan (foreign) 'v ee - x a n /'vɛː.χan/
fedar (foreign) 'v ee - d a r /'vɛː.dar/
feddygon v e - 'dh @ - g o n /vɛ.'ðə.gɔn/
fedrach (foreign) 'v e d - r a x /'vɛd.raχ/
feidir (foreign) 'v ei - d i r /'vəɪ.dɪr/
feiral 'v ei - r a l /'vəɪ.ral/
felen 'v e - l e n /'vɛ.lɛn/
feliau (foreign) 'v e l - j ay /'vɛl.jaɨ/
felly'n 'v e - lh y n /'vɛ.ɬɨn/
felna 'v e l - n a /'vɛl.na/
fenis 'v e - n i s /'vɛ.nɪs/
fenw (foreign) 'v e - n u /'vɛ.nʊ/
ferchar (foreign) 'v e r - x a r /'vɛr.χar/
ferrar 'v e - r a r /'vɛ.rar/
festvox 'f e s t - v o k s /'fɛst.vɔks/
fetalau v e - 't a - l ay /vɛ.'ta.laɨ/
feu e - f ii - 'iu /ɛ.fɪː.'ɪʊ/
ffansins 'f a n - s i n s /'fan.sɪns/
ffansîns f a n - 's ii n s /fan.'sɪːns/
ffarar 'f a - r a r /'fa.rar/
ffarenheit (foreign) f a - 'r e n hh ei t /fa.'rɛnhəɪt/
ffariar (foreign) 'f a r - j a r /'far.jar/
ffarms (foreign) 'f a r m z /'farmz/
ffatrioedd 'f a t - r j oy dh /'fat.rjɔɨð/
ffatwa (foreign) 'f a t - w a /'fat.wa/
ffeinal (foreign) 'f ei - n a l /'fəɪ.nal/
ffeinals (foreign) 'f ei - n a l s /'fəɪ.nals/
ffeirad 'f ei - r a d /'fəɪ.rad/
ffeirad (foreign) 'f ei - r a d /'fəɪ.rad/
ffeit (foreign) 'f ei t /'fəɪt/
ffenast (foreign) 'f e - n a s t /'fɛ.nast/
ffer (foreign) 'f e r /'fɛr/
fferam 'f e - r a m /'fɛ.ram/
fferyll (foreign) 'f e - r y lh /'fɛ.rɨɬ/
ffgg e - f e - 'g e g /ɛ.fɛ.'gɛg/
ffiar (foreign) 'f j a r /'fjar/
ffibril (foreign) 'f i b - r i l /'fɪb.rɪl/
ffibrilau f i b - 'r i - l ay /fɪb.'rɪ.laɨ/
ffitiach 'f i t - j a x /'fɪt.jaχ/
fflachlamp (foreign) 'f l a x - l a m p /'flaχ.lamp/
fflio (foreign) 'f l j oo /'fljɔː/
ffloat (foreign) 'f l 'ou t /'fl'əʊt/
fflorens 'f l o - r e n s /'flɔ.rɛns/
fflos (foreign) 'f l oo s /'flɔːs/
fflwffen (foreign) 'f l uu - f e n /'flʊː.fɛn/
ffocol 'f o - k o l /'fɔ.kɔl/
ffolliaid 'f o lh - j ai d /'fɔɬ.jaɪd/
ffond 'f o n d /'fɔnd/
ffond (foreign) 'f o n d /'fɔnd/
fford (foreign) 'f o r d /'fɔrd/
fformatiau f o r - 'm a t - j ay /fɔr.'mat.jaɨ/
ffram 'f r a m /'fram/
ffredi 'f r ee - d i /'frɛː.dɪ/
ffrindia 'f r i n - d j a /'frɪn.dja/
ffrindie 'f r i n - d j e /'frɪn.djɛ/
ffrisbi (foreign) 'f r i s - p i /'frɪs.pɪ/
ffriwleg 'f r iu - l e g /'frɪʊ.lɛg/
ffrwydriad 'f r uy d - r j a d /'frʊɨd.rjad/
ffrwydriadau f r uy d - 'r j aa - d ay /frʊɨd.'rjaː.daɨ/
ffug- 'f yy g /'fɨːg/
ffuglennol f y g - 'l e - n o l /fɨg.'lɛ.nɔl/
ffwl (foreign) 'f u l /'fʊl/
ffwlerenau f u - l e - 'r e - n ay /fʊ.lɛ.'rɛ.naɨ/
ffynonellu (foreign) f @ - n o - 'n e - lh y /fə.nɔ.'nɛ.ɬɨ/
ffyrnicach f @ r - 'n i - k a x /fər.'nɪ.kaχ/
ffyrnicaf f @ r - 'n i - k a v /fər.'nɪ.kav/
ffys (foreign) 'f yy s /'fɨːs/
ffôr 'f oo r /'fɔːr/
fhsa e - f ee - ch e - 's ee /ɛ.fɛː.tʃɛ.'sɛː/
fideos v i - 'd e - o s /vɪ.'dɛ.ɔs/
fielden 'f ii l - d @ n /'fɪːl.dən/
fiet (foreign) 'v j e t /'vjɛt/
filfeddygon v i l - v e - 'dh @ - g o n /vɪl.vɛ.'ðə.gɔn/
finna 'v i - n a /'vɪ.na/
finne 'v i - n e /'vɪ.nɛ/
fionn 'f ii - o n /'fɪː.ɔn/
fishlock 'v i sh - l o k /'vɪʃ.lɔk/
fishman 'v i sh - m a n /'vɪʃ.man/
fisitors (foreign) v i - 's i - t o r s /vɪ.'sɪ.tɔrs/
fivet 'v i - v e t /'vɪ.vɛt/
flaengareddau v l aay - ng a - 'r ee - dh ay /vlɑɨ.ŋa.'rɛː.ðaɨ/
floda 'v l oo - d a /'vlɔː.da/
florrie 'v l o r - j e /'vlɔr.jɛ/
fmln v m l n /vmln/
foelas (foreign) 'v oy - l a s /'vɔɨ.las/
folkdance (foreign) v o l k - 'd a ng - k e /vɔlk.'daŋ.kɛ/
folklóric (foreign) v o l - 'k l o - r i k /vɔl.'klɔ.rɪk/
fon 'v o n /'vɔn/
foslemaidd v o s - 'l e - m ai dh /vɔs.'lɛ.maɪð/
foty 'v o - t y /'vɔ.tɨ/
foxyvoice 'f o k - s i - v oi s /'fɔk.sɪ.vɔɪs/
fraith 'v r ai th /'vraɪθ/
francaise (foreign) v r a ng - 'k ai - s e /vraŋ.'kaɪ.sɛ/
freiburg 'v r ei - b y r g /'vrəɪ.bɨrg/
friesland 'f r ii s - l a n d /'frɪːs.land/
frigad (foreign) 'v r ii - g a d /'vrɪː.gad/
frogwy 'v r oo - g uy /'vrɔː.gʊɨ/
froncysyllte v r o ng - k @ - 's @ lh - t e /vrɔŋ.kə.'səɬ.tɛ/
frondeg 'v r o n - d e g /'vrɔn.dɛg/
froude 'v r oy - d e /'vrɔɨ.dɛ/
fryslân v r @ s - 'l aa n /vrəs.'laːn/
fsh e - f e - 's ee ch /ɛ.fɛ.'sɛːtʃ/
fuais v yy - ai s /vɨː.aɪs/
fuaist v yy - ai s t /vɨː.aɪst/
fuasen v y - a - s e n /vɨ.a.sɛn/
funtauna v y n - 't ay - n a /vɨn.'taɨ.na/
fuo 'v y - o /'vɨ.ɔ/
fuo (foreign) 'v y - o /'vɨ.ɔ/
furlan 'f @@ - l @ n /'fɜː.lən/
fwcwl (foreign) 'v u - k u l /'vʊ.kʊl/
fwystfilod v uy s t - 'v i - l o d /vʊɨst.'vɪ.lɔd/
fyddai'n v @ - dh ai n /və.ðaɪn/
fyddai'r v @ - dh ai r /və.ðaɪr/
fynachod v @ - 'n aa - x o d /və.'naː.χɔd/
fynes-clinton 'v @ - n e s - 'k l i n - t o n /'və.nɛs.'klɪn.tɔn/
fynglwyd 'v @ ng - l uy d /'vəŋ.lʊɨd/
fythynod v @ - 'th @ - n o d /və.'θə.nɔd/
fywiai (foreign) 'v yu - j ai /'vɨʊ.jaɪ/
féin (foreign) 'v ei n /'vəɪn/
fêts (foreign) 'v ee t s /'vɛːts/
fîn (foreign) f ii n /fɪːn/
g 'jh ii /'dʒɪː/
g (nmcy) 'e g /'ɛg/
gaclwn 'g a k - l u n /'gak.lʊn/
gadaffi g a - 'd aa - f i /ga.'daː.fɪ/
gadarnach g a - 'd a r - n a x /ga.'dar.naχ/
gaddo 'g aa - dh o /'gaː.ðɔ/
gadw'r g a - 'd u r /ga.'dʊr/
gaelige 'g a - l i g /'ga.lɪg/
gaffis 'g aa - f i s /'gaː.fɪs/
gaiman 'g ai - m a n /'gaɪ.man/
galanasdra g a - l a - 'n a s - t r a /ga.la.'nas.tra/
galau 'g a - l ay /'ga.laɨ/
galeg 'g a - l e g /'ga.lɛg/
galiffornia g a - l i - 'f o r - n j a /ga.lɪ.'fɔr.nja/
galio (foreign) 'g a l - j o /'gal.jɔ/
gallen 'g a - lh e n /'ga.ɬɛn/
gallesid g a - 'lh ee - s i d /ga.'ɬɛː.sɪd/
gallsai 'g a lh - s ai /'gaɬ.saɪ/
galluocaf g a - lh y - 'o - k a v /ga.ɬɨ.'ɔ.kav/
gambella g a m - 'b e - lh a /gam.'bɛ.ɬa/
gamdrin 'g a m - d r i n /'gam.drɪn/
ganddom 'g a n - dh o m /'gan.ðɔm/
ganfas 'g a n - v a s /'gan.vas/
ganiatad g a n - 'j a - t a d /gan.'ja.tad/
ganiatau g a n - 'j a - t ay /gan.'ja.taɨ/
ganthaw (foreign) 'g a n - th au /'gan.θaʊ/
garafanwyr g a - r a - 'v a - n uy r /ga.ra.'va.nʊɨr/
gardden 'g a r - dh e n /'gar.ðɛn/
garddyrnau g a r - 'dh @ r - n ay /gar.'ðər.naɨ/
garel 'g a - r e l /'ga.rɛl/
garel-jones 'g a - r e l - 'jh ou n z /'ga.rɛl.'dʒəʊnz/
gariadon g a r - 'j aa - d o n /gar.'jaː.dɔn/
garwed 'g a r - w e d /'gar.wɛd/
gategoriau g a - t e - 'g o r - j ay /ga.tɛ.'gɔr.jaɨ/
gatti 'g a - t i /'ga.tɪ/
gde e g - d ii - 'ee /ɛg.dɪː.'ɛː/
gdu jh ii - d ii - 'iu /dʒɪː.dɪː.'ɪʊ/
gebyst 'g ee - b y s t /'gɛː.bɨst/
gebyst (foreign) 'g ee - b y s t /'gɛː.bɨst/
gefnogi'r g e v - 'n oo - g i r /gɛv.'nɔː.gɪr/
geiriaduron g ei r - j a - 'd y - r o n /gəɪr.ja.'dɨ.rɔn/
geirionydd g ei r - 'j o - n y dh /gəɪr.'jɔ.nɨð/
geldof 'g e l - d o v /'gɛl.dɔv/
gelliwig g e - 'lh i - w i g /gɛ.'ɬɪ.wɪg/
gemingay (foreign) jh 'e - m i ng 'ei /dʒ'ɛ.mɪŋ'əɪ/
gemp 'g e m p /'gɛmp/
genethod g e - 'n ee - th o d /gɛ.'nɛː.θɔd/
geninen (foreign) g e - 'n i - n e n /gɛ.'nɪ.nɛn/
gepp 'g e p /'gɛp/
gere 'g e - r e /'gɛ.rɛ/
gereint 'g e - r ei n t /'gɛ.rəɪnt/
gerisim g e - 'r ii - s i m /gɛ.'rɪː.sɪm/
gerson 'g e r - s o n /'gɛr.sɔn/
geufron 'g ey v - r o n /'gəɨv.rɔn/
gewin 'g e - w i n /'gɛ.wɪn/
ghaeilge 'g e - l i g /'gɛ.lɪg/
ghali 'g hh a - l i /'gha.lɪ/
ghandi 'g hh a n - d i /'ghan.dɪ/
ghose 'g hh oo - s e /'ghɔː.sɛ/
giamocs (foreign) 'g j a - m o k s /'gja.mɔks/
giard (foreign) 'g j a r d /'gjard/
giat (foreign) 'g j a t /'gjat/
gibea g i - 'b e - a /gɪ.'bɛ.a/
gibea (foreign) g 'i b 'ii /g'ɪb'ɪː/
gibeon (foreign) g 'i b 'ei - @ n /g'ɪb'əɪ.ən/
gidden 'g i - d @ n /'gɪ.dən/
gide 'g ii - d e /'gɪː.dɛ/
gilboa (foreign) g 'i l - b 'ou /g'ɪl.b'əʊ/
gilgal (foreign) 'g i l - g a l /'gɪl.gal/
gilgwri g i l - 'g u - r i /gɪl.'gʊ.rɪ/
gitar 'g i - t a r /'gɪ.tar/
gittins 'g i - t i n s /'gɪ.tɪns/
glanach 'g l a - n a x /'gla.naχ/
glanaf 'g l a - n a v /'gla.nav/
glangwili g l a ng - 'w i - l i /glaŋ.'wɪ.lɪ/
glasaid 'g l aa - s ai d /'glaː.saɪd/
glasiad 'g l a - sh a d /'gla.ʃad/
glendower (foreign) g l e n - 'd o - w e r /glɛn.'dɔ.wɛr/
glle 'g lh ee /'gɬɛː/
glo:wr 'g l o - u r /'glɔ.ʊr/
glo:yn 'g l o - y n /'glɔ.ɨn/
gloesi (foreign) 'g l oy - s i /'glɔɨ.sɪ/
glowr 'g l ou r /'gləʊr/
gloynnod 'g l oy - n o d /'glɔɨ.nɔd/
glyndwr 'g l @ n - d u r /'glən.dʊr/
glynne 'g l @ - n e /'glə.nɛ/
glyntraian g l @ n - 't r a - j a n /glən.'tra.jan/
glywad (foreign) 'g l @ - w a d /'glə.wad/
glós 'g l oo s /'glɔːs/
gngh jh ii - e n - jh ii - 'ee ch /dʒɪː.ɛn.dʒɪː.'ɛːtʃ/
gnosticaidd g n o s - 't i - k ai dh /gnɔs.'tɪ.kaɪð/
gnosticiaid g n o s - 't i k - j ai d /gnɔs.'tɪk.jaɪd/
gnvq jh ii - e n - v ii - 'k iu /dʒɪː.ɛn.vɪː.'kɪʊ/
godley 'g o d - l ey /'gɔd.ləɨ/
gododdin g o - 'd oo - dh i n /gɔ.'dɔː.ðɪn/
goetra 'g oy t - r a /'gɔɨt.ra/
gofebau g o - 'v ee - b ay /gɔ.'vɛː.baɨ/
gogs 'g o g s /'gɔgs/
gole 'g o - l e /'gɔ.lɛ/
golgeidwad g o l - 'g ei d - w a d /gɔl.'gəɪd.wad/
gomon (foreign) 'g o - m o n /'gɔ.mɔn/
gopaon g o - 'p a - o n /gɔ.'pa.ɔn/
gorad 'g o - r a d /'gɔ.rad/
gorddweud 'g o r - dh w ey d /'gɔr.ðwəɨd/
gorfadd (foreign) 'g o r - v a dh /'gɔr.vað/
gorffan (foreign) 'g o r - f a n /'gɔr.fan/
gorfrwdfrydig g o r - v r u d - 'v r @ - d i g /gɔr.vrʊd.'vrə.dɪg/
gorgynhyrchu g o r - 'g @ n hh @ r - x y /gɔr.'gənhər.χɨ/
gorinth (foreign) g o - 'r i n - th /gɔ.'rɪn.θ/
gorseddol g o r - 's ee - dh o l /gɔr.'sɛː.ðɔl/
gorsymleiddio g o r - s @ m - 'l ei dh - j o /gɔr.səm.'ləɪð.jɔ/
goruchwilio g o - r y x - 'w i l - j o /gɔ.rɨχ.'wɪl.jɔ/
gosbin (foreign) 'g o s - p i n /'gɔs.pɪn/
gosteffeithiol g o s - t e - 'f ei th - j o l /gɔs.tɛ.'fəɪθ.jɔl/
gov 'g o v /'gɔv/
graal (foreign) g r aa l /graːl/
gradgrind 'g r a d - g r i n d /'grad.grɪnd/
grahame 'g r ee - @ m /'grɛː.əm/
gramaffôn (foreign) g r a - m a - 'f oo n /gra.ma.'fɔːn/
granet 'g r a - n e t /'gra.nɛt/
grango 'g r a - ng o /'gra.ŋɔ/
grantio (foreign) 'g r a n - t j o /'gran.tjɔ/
granvilles 'g r a n - v i l z /'gran.vɪlz/
grat 'g r a t /'grat/
greenacres g r ii - 'n a k - r e s /grɪː.'nak.rɛs/
greenham g r e - 'e n hh a m /grɛ.'ɛnham/
greenhill g r e - 'e n hh i lh /grɛ.'ɛnhɪɬ/
grehan 'g r e - hh a n /'grɛ.han/
gresford 'g r e s - v o r d /'grɛs.vɔrd/
greu'r 'g r ey r /'grəɨr/
grewyd 'g r e - w y d /'grɛ.wɨd/
griffi 'g r ii - f i /'grɪː.fɪ/
grinc (foreign) 'g r i ng k /'grɪŋk/
grindal 'g r i n - d a l /'grɪn.dal/
grisiwn (foreign) 'g r ii - s iu n /'grɪː.sɪʊn/
grp jh ii - aa r - 'p ii /dʒɪː.aːr.'pɪː/
gruagáin 'g r uu - g ai n /'grʊː.gaɪn/
gruffuddiaid (foreign) 'g r y - f y dh - j ai d /'grɨ.fɨð.jaɪd/
grup (foreign) 'g r y p /'grɨp/
grw 'g r uu /'grʊː/
grwp 'g r u p /'grʊp/
gryfach 'g r @ - v a x /'grə.vaχ/
gryfaf 'g r @ - v a v /'grə.vav/
gsi jh ii - e - 's ai /dʒɪː.ɛ.'saɪ/
gss jh ii - e - 's e s /dʒɪː.ɛ.'sɛs/
gtaa jh ii - t ii - ee - 'ee /dʒɪː.tɪː.ɛː.'ɛː/
gua jh ii - iu - 'ee /dʒɪː.ɪʊ.'ɛː/
gudrun 'g y d - r y n /'gɨd.rɨn/
guilfoyle 'g i l - f oi l /'gɪl.fɔɪl/
guiness (foreign) g y - 'i - n e s /gɨ.'ɪ.nɛs/
gulach 'g y - l a x /'gɨ.laχ/
gumperz 'g y m - p e r z /'gɨm.pɛrz/
gutiérrez g y t - 'j e - r e z /gɨt.'jɛ.rɛz/
guía 'g ii - a /'gɪː.a/
gwaddodoleg g w a - dh o - 'd o - l e g /gwa.ðɔ.'dɔ.lɛg/
gwaethfoed 'g w aay th - v oy d /'gwɑɨθ.vɔɨd/
gwagsymera g w a g - s @ - 'm e - r a /gwag.sə.'mɛ.ra/
gwahaniaethedd g w a - hh a n - 'j aay - th e dh /gwa.han.'jɑɨ.θɛð/
gwahanolrwydd g w a - hh a - 'n o l - r uy dh /gwa.ha.'nɔl.rʊɨð/
gwalarn 'g w a - l a r n /'gwa.larn/
gwallgo 'g w a lh - g o /'gwaɬ.gɔ/
gwallgofgell g w a lh - 'g o v - g e lh /gwaɬ.'gɔv.gɛɬ/
gwannach 'g w a - n a x /'gwa.naχ/
gwannaf 'g w a - n a v /'gwa.nav/
gwaredigol g w a - r e - 'd ii - g o l /gwa.rɛ.'dɪː.gɔl/
gwareiddiol g w a - 'r ei dh - j o l /gwa.'rəɪð.jɔl/
gwatsiad (foreign) 'g w a - ch a d /'gwa.tʃad/
gwblhau'r g u - b u l - hh ay r /gʊ.bʊl.haɨr/
gwbod 'g uu - b o d /'gʊː.bɔd/
gwbod (foreign) 'g uu - b o d /'gʊː.bɔd/
gwbwl (foreign) 'g uu - b u l /'gʊː.bʊl/
gwe-freiddio 'g w ee v - 'r ei dh - j o /'gwɛːv.'rəɪð.jɔ/
gwe-freiddiol 'g w ee v - 'r ei dh - j o l /'gwɛːv.'rəɪð.jɔl/
gwecam 'g w e - k a m /'gwɛ.kam/
gwecamerau g w e - k a - 'm e - r ay /gwɛ.ka.'mɛ.raɨ/
gweddiau 'g w e dh - j ay /'gwɛð.jaɨ/
gweddio 'g w e dh - j o /'gwɛð.jɔ/
gweithio'n 'g w ei th - j o n /'gwəɪθ.jɔn/
gwelis (foreign) 'g w e - l i s /'gwɛ.lɪs/
gwella'r 'g w e - lh a r /'gwɛ.ɬar/
gwelywio g w e - 'l yu - j o /gwɛ.'lɨʊ.jɔ/
gwenfro 'g w e n - v r o /'gwɛn.vrɔ/
gwenllian 'g w e n lh - j a n /'gwɛnɬ.jan/
gwerthfawrocach g w e r th - v au - 'r o - k a x /gwɛrθ.vaʊ.'rɔ.kaχ/
gwerthfawrocaf g w e r th - v au - 'r o - k a v /gwɛrθ.vaʊ.'rɔ.kav/
gwesteiol g w e s - 't e - j o l /gwɛs.'tɛ.jɔl/
gweud 'g w ey d /'gwəɨd/
gweud (foreign) 'g w ey d /'gwəɨd/
gwil 'g w i l /'gwɪl/
gwilim 'g w i - l i m /'gwɪ.lɪm/
gwiriedig w i - r i - 'ee - d i g ENG /wɪ.rɪ.'ɛː.dɪgENG/
gwiwerod g w i - 'w e - r o d /gwɪ.'wɛ.rɔd/
gwlannog g lw - 'a - n o g /glw.'a.nɔg/
gwlypach g lw - '@ - p a x /glw.'ə.paχ/
gwmniau 'g u m - n j ay /'gʊm.njaɨ/
gwnai 'g u - n ai /'gʊ.naɪ/
gwnant 'g nw a n t /'gnwant/
gwnio 'g u n - j o /'gʊn.jɔ/
gwrachod 'g rw aa - x o d /'grwaː.χɔd/
gwrandawr 'g rw a n - d au r /'grwan.daʊr/
gwreiddiolaf g u - r ei dh - 'j o - l a v /gʊ.rəɪð.'jɔ.lav/
gwreng 'g rw e ng /'grwɛŋ/
gwrgant 'g u r - g a n t /'gʊr.gant/
gwrth-gristnogol 'g u r th - g r i s t - 'n oo - g o l /'gʊrθ.grɪst.'nɔː.gɔl/
gwrth-gymreigrwydd 'g u r th - g @ m - 'r ei g - r uy dh /'gʊrθ.gəm.'rəɪg.rʊɨð/
gwrthdwyll 'g u r th - d uy lh /'gʊrθ.dʊɨɬ/
gwrthgrefyddol g u r th - g r e - 'v @ - dh o l /gʊrθ.grɛ.'və.ðɔl/
gwrthgylchol g u r th - 'g @ l - x o l /gʊrθ.'gəl.χɔl/
gwrywod 'g u - 'r @ - w o d /'gʊ.'rə.wɔd/
gwsberins g u s - 'p e - r i n s /gʊs.'pɛ.rɪns/
gwscwm (foreign) 'g u s - k u m /'gʊs.kʊm/
gwybedog g uy - 'b ee - d o g /gʊɨ.'bɛː.dɔg/
gwybodau g uy - 'b oo - d ay /gʊɨ.'bɔː.daɨ/
gwychion 'g w @ x - j o n /'gwəχ.jɔn/
gwychoniaeth g uy - 'x o n - j aay th /gʊɨ.'χɔn.jɑɨθ/
gwyddalus g uy - 'dh a - l y s /gʊɨ.'ða.lɨs/
gwyddelod g uy - 'dh e - l o d /gʊɨ.'ðɛ.lɔd/
gwyddonaidd g uy - 'dh o - n ai dh /gʊɨ.'ðɔ.naɪð/
gwyddoniaduron g uy - dh o n - j a - 'd y - r o n /gʊɨ.ðɔn.ja.'dɨ.rɔn/
gwydir 'g w @ - d i r /'gwə.dɪr/
gwydir (foreign) 'g w @ - d i r /'gwə.dɪr/
gwydyr 'g w @ - d y r /'gwə.dɨr/
gwyfynod g uy - 'v @ - n o d /gʊɨ.'və.nɔd/
gwylanod g uy - 'l a - n o d /gʊɨ.'la.nɔd/
gwyndoleg g uy n - 'd o - l e g /gʊɨn.'dɔ.lɛg/
gwyneddigion g uy - n e - 'dh i g - j o n /gʊɨ.nɛ.'ðɪg.jɔn/
gwyniedyn g uy n - 'j ee - d y n /gʊɨn.'jɛː.dɨn/
gwynne 'g w @ - n e /'gwə.nɛ/
gwythienna g uy th - 'j e - n a /gʊɨθ.'jɛ.na/
gwâdd 'g w aa dh /'gwaːð/
gybyddus g @ - 'b @ - dh y s /gə.'bə.ðɨs/
gyda'ch g @ - d a @ x /gə.daəχ/
gyda'n g @ - d a n /gə.dan/
gyda'r g @ - d a r /gə.dar/
gyda'u g @ - d a y /gə.daɨ/
gydd 'g yy dh /'gɨːð/
gydfynd 'g @ d - v y n d /'gəd.vɨnd/
gyfangwbl g @ - v a - 'ng uu - b u l /gə.va.'ŋʊː.bʊl/
gyflawni'r g @ v - 'l au - n i r /gəv.'laʊ.nɪr/
gyflwyno'r g @ v - 'l uy - n o r /gəv.'lʊɨ.nɔr/
gyflymach g @ v - 'l @ - m a x /gəv.'lə.maχ/
gyfoethocach g @ - v oy - 'th o - k a x /gə.vɔɨ.'θɔ.kaχ/
gyfrifiaduron g @ v - r i v - j a - 'd y - r o n /gəv.rɪv.ja.'dɨ.rɔn/
gymhedrol 'g @ m hh e d - r o l /'gəmhɛd.rɔl/
gymra'g 'g @ m - r a g /'gəm.rag/
gyprus 'g @ p - r y s /'gəp.rɨs/
gyrradd 'g @ - r a dh /'gə.rað/
gyrrwyr 'g @ - r uy r /'gə.rʊɨr/
gysact 'g @ - s a k t /'gə.sakt/
gysact (foreign) 'g @ - s a k t /'gə.sakt/
gysta 'g @ s - t a /'gəs.ta/
gâm 'g aa m /'gaːm/
gêmau 'g ee - m ay /'gɛː.maɨ/
górecki (foreign) 'g o - r e - k i /'gɔ.rɛ.kɪ/
gôd 'g oo d /'gɔːd/
gŵyn 'g uu - y n /'gʊː.ɨn/
h 'ei ch /'əɪtʃ/
h (nmcy) 'aay ch /'ɑɨtʃ/
habakkuk (foreign) hh a - 'b a - 'k k uu - k /ha.'ba.'kkʊː.k/
hachmoniad (foreign) 'hh aa - x - 'm o n - j a d /'haː.χ.'mɔn.jad/
hacni (foreign) 'hh a k - n i /'hak.nɪ/
hadad 'hh aa - d a d /'haː.dad/
hadadeser (foreign) hh a - d a - 'd ee - s e r /ha.da.'dɛː.sɛr/
haerai 'hh aay - r ai /'hɑɨ.raɪ/
haerodd 'hh aay - r o dh /'hɑɨ.rɔð/
hafoc (foreign) 'hh aa - v o k /'haː.vɔk/
hafodymaidd hh a - v o - 'd @ - m ai dh /ha.vɔ.'də.maɪð/
haile 'hh ai - l e /'haɪ.lɛ/
hain 'hh ai n /'haɪn/
haines 'hh ai - n e s /'haɪ.nɛs/
haldane hh a l - 'd a - n e /hal.'da.nɛ/
halelwia hh a - l e - 'l u - j a /ha.lɛ.'lʊ.ja/
halelwia (foreign) hh a - l e - 'l u - j a /ha.lɛ.'lʊ.ja/
halliday hh a - 'lh ii - d a - y /ha.'ɬɪː.da.ɨ/
halliwell 'hh a - l i - w e l /'ha.lɪ.wɛl/
hameln 'hh a - m e l n /'ha.mɛln/
hannar (foreign) 'hh a - n a r /'ha.nar/
hanney 'hh a - n ii /'ha.nɪː/
hapusach hh a - 'p yy - s a x /ha.'pɨː.saχ/
harddach 'hh a r - dh a x /'har.ðaχ/
hardie 'hh a r - d j e /'har.djɛ/
harfleur 'hh a r - v l ey r /'har.vləɨr/
harti 'hh a r - t i /'har.tɪ/
harti (foreign) 'hh a r - t i /'har.tɪ/
hartisheik hh a r - 't i - sh ei k /har.'tɪ.ʃəɪk/
hasawa hh a - 's a - u a /ha.'sa.ʊa/
haseley hh a - 's e - l ey /ha.'sɛ.ləɨ/
hasguard hh a s - 'k y - a r d /has.'kɨ.ard/
hassal (foreign) hh 'a - s @ l /h'a.səl/
hassan 'hh a - s a n /'ha.san/
hatton 'hh a - t o n /'ha.tɔn/
hawduron hh au - 'd y - r o n /haʊ.'dɨ.rɔn/
hbj hh b jh /hbdʒ/
hc hh k /hk/
hebddoch hh ee b - dh o x /hɛːb.ðɔχ/
hebddon hh ee b - dh o n /hɛːb.ðɔn/
hebddot hh ee b - dh o t /hɛːb.ðɔt/
heddyw 'hh ee - dh yu /'hɛː.ðɨʊ/
hefo'r 'hh ee - v o r /'hɛː.vɔr/
heiddan 'hh ei - dh a n /'həɪ.ðan/
heiddan (foreign) 'hh ei - dh a n /'həɪ.ðan/
heilin (foreign) 'hh ei - l i n /'həɪ.lɪn/
heinemann hh ei - 'n e - m a n /həɪ.'nɛ.man/
helaethach hh e - 'l aay - th a x /hɛ.'lɑɨ.θaχ/
helbulon hh e l - 'b y - l o n /hɛl.'bɨ.lɔn/
helder 'hh e l - d e r /'hɛl.dɛr/
helflaidd (foreign) 'hh e l - v l ai dh /'hɛl.vlaɪð/
helga 'hh e l - g a /'hɛl.ga/
helpu'r 'hh e l - p y r /'hɛl.pɨr/
helvetica (foreign) hh e l - v e - 't i - k a /hɛl.vɛ.'tɪ.ka/
hen-destamentyddol 'hh ee n - d e s - t a - m e n - 't @ - dh o l /'hɛːn.dɛs.ta.mɛn.'tə.ðɔl/
hendregadredd hh e n - d r e - 'g a d - r e dh /hɛn.drɛ.'gad.rɛð/
hendygwyn hh e n - 'd @ - g uy n /hɛn.'də.gʊɨn/
henedd 'hh e - n e dh /'hɛ.nɛð/
heneghan hh e - 'n e g - hh a n /hɛ.'nɛg.han/
henfro 'hh e n - v r o /'hɛn.vrɔ/
heng 'hh e ng /'hɛŋ/
hengae 'hh e - ng aay /'hɛ.ŋɑɨ/
henrickse hh e n - 'r i k - s e /hɛn.'rɪk.sɛ/
henricus 'hh e - n - r i - k @ s /'hɛ-n.rɪ.kəs/
herber 'hh e r - b e r /'hɛr.bɛr/
herderaidd hh e r - 'd e - r ai dh /hɛr.'dɛ.raɪð/
herderiaeth hh e r - 'd e r - j aay th /hɛr.'dɛr.jɑɨθ/
herodianiaid (foreign) hh e - r o d - 'j a n - j ai d /hɛ.rɔd.'jan.jaɪd/
herriot 'hh e r - j o t /'hɛr.jɔt/
hertzberg hh @@ t z b @@ g /hɜːtzbɜːg/
hethiad (foreign) 'hh e th - j a d /'hɛθ.jad/
heyrs (foreign) 'hh ey r s /'həɨrs/
hilberson hh i l - 'b e r - s o n /hɪl.'bɛr.sɔn/
hilfry (foreign) 'hh i l - v r y /'hɪl.vrɨ/
himps 'hh i m p s /'hɪmps/
hindw (foreign) 'hh i n - d u /'hɪn.dʊ/
hindwaeth 'hh i n d - w aay th /'hɪnd.wɑɨθ/
hirgoes 'hh i r - g oy s /'hɪr.gɔɨs/
historia (foreign) hh i s - 't o r - j a /hɪs.'tɔr.ja/
hitha 'hh ii - th a /'hɪː.θa/
hithe 'hh ii - th e /'hɪː.θɛ/
hiwmanistaidd hh iu - m a - 'n i s - t ai dh /hɪʊ.ma.'nɪs.taɪð/
hm (foreign) hh m /hm/
hn ee - 'ch e n /ɛː.'tʃɛn/
hoddni 'hh o dh - n i /'hɔð.nɪ/
hodgkins (foreign) 'hh o d - g k i n s /'hɔd.gkɪns/
hofeldai hh o - 'v e l - d ai /hɔ.'vɛl.daɪ/
hoffi'r 'hh oo - f i r /'hɔː.fɪr/
hogia 'hh o g - j a /'hɔg.ja/
holand 'hh o - l a n d /'hɔ.land/
holiaduron hh o l - j a - 'd y - r o n /hɔl.ja.'dɨ.rɔn/
honddu 'hh o n - dh y /'hɔn.ðɨ/
honglad (foreign) 'hh o ng - l a d /'hɔŋ.lad/
honglaid (foreign) 'hh o ng - l ai d /'hɔŋ.laɪd/
hopkin 'hh o p - k i n /'hɔp.kɪn/
hopkyn 'hh o p - k y n /'hɔp.kɨn/
horas 'hh o - r a s /'hɔ.ras/
horlicks (foreign) 'hh o r - l i k s /'hɔr.lɪks/
hort 'hh o r t /'hɔrt/
horwth 'hh o - r u th /'hɔ.rʊθ/
horwth (foreign) 'hh o - r u th /'hɔ.rʊθ/
howel 'hh o - w e l /'hɔ.wɛl/
howells 'hh o - w e lh s /'hɔ.wɛɬs/
howsgipar (foreign) hh ou s - 'k i - p a r /həʊs.'kɪ.par/
hoxton 'hh o k - s t @ n /'hɔk.stən/
hridesh 'hh r ii - d e sh /'hrɪː.dɛʃ/
hrp ee - ch aa r - 'p ii /ɛː.tʃaːr.'pɪː/
hsff ai - ch e - 's e f /aɪ.tʃɛ.'sɛf/
huana hh y - 'a - n a /hɨ.'a.na/
huet 'hh y - e t /'hɨ.ɛt/
huffmann 'hh y f - m a n /'hɨf.man/
huliodd (foreign) 'hh y l - j o dh /'hɨl.jɔð/
hulse 'hh y l - s e /'hɨl.sɛ/
humani (foreign) hh y - 'm a - n i /hɨ.'ma.nɪ/
hunanbarch hh y - 'n a n - b a r x /hɨ.'nan.barχ/
hunangais hh y - 'n a - ng ai s /hɨ.'na.ŋaɪs/
hurd 'hh y r d /'hɨrd/
hurrell 'hh y - r e lh /'hɨ.rɛɬ/
huss 'hh y s /'hɨs/
hussiaid (foreign) 'hh y s - j ai d /'hɨs.jaɪd/
hwfar (foreign) 'hh uu - v a r /'hʊː.var/
hwfer (foreign) 'hh uu - v e r /'hʊː.vɛr/
hwngarian hh u - 'ng a r - j a n /hʊ.'ŋar.jan/
hwylddydd 'hh uy l - dh y dh /'hʊɨl.ðɨð/
hwylie 'hh uy l - j e /'hʊɨl.jɛ/
hwylusach hh uy - 'l yy - s a x /hʊɨ.'lɨː.saχ/
hwynthwy hh w y n t - 'hh uy /hwɨnt.'hʊɨ/
hybu'r 'hh @ - b y r /'hə.bɨr/
hyd-ddon 'hh yy d - dh o n /'hɨːd.ðɔn/
hyfedrwydd hh @ - 'v e d - r uy dh /hə.'vɛd.rʊɨð/
hyfforddiant-mewn- hh @ - 'f o r - 'dh j a n t - 'm eu n /hə.'fɔr.'ðjant.'mɛʊn/
hyfrytaf hh @ v - 'r @ - t a v /həv.'rə.tav/
hyfrytaf (foreign) hh @ v - 'r @ - 't aa v /həv.'rə.'taːv/
hyllaf 'hh @ - lh a v /'hə.ɬav/
hylo (foreign) 'hh @ - l o /'hə.lɔ/
hylô (foreign) hh @ - 'l oo /hə.'lɔː/
hynafolrwydd hh @ - n a - 'v o l - r uy dh /hə.na.'vɔl.rʊɨð/
hynny'n 'hh @ - n y n /'hə.nɨn/
hyny (foreign) 'hh @ - n y /'hə.nɨ/
hypothermig hh @ - p o - 'th e r - m i g /hə.pɔ.'θɛr.mɪg/
hyrwyddo'r hh @ - 'r uy - dh o r /hə.'rʊɨ.ðɔr/
hywal 'hh @ - w a l /'hə.wal/
hélias 'hh e l - j a s /'hɛl.jas/
hêd 'hh ee d /'hɛːd/
hôb 'hh oo b /'hɔːb/
hünxe 'hh y n k s e /'hɨnksɛ/
hŷ (foreign) 'hh yy /'hɨː/
iachach 'j aa - x a x /'jaː.χaχ/
iachäwr j a - 'x a - u r /ja.'χa.ʊr/
iahwe 'j a hh - w e /'jah.wɛ/
iats ai - ee - t ii - 'e s /aɪ.ɛː.tɪː.'ɛs/
ibhar (foreign) 'i - b - hh o r /'ɪ.b.hɔr/
ibn 'ii - b i n /'ɪː.bɪn/
ichabod (foreign) 'j 'x aa - b o d /'j'χaː.bɔd/
ico ai - s ii - 'oo /aɪ.sɪː.'ɔː/
iddaw (foreign) 'ii - dh au /'ɪː.ðaʊ/
iddew-almaeneg 'ii - dh eu - a l - 'm aay - n e g /'ɪː.ðɛʊ.al.'mɑɨ.nɛg/
iddon 'i - dh o n /'ɪ.ðɔn/
ieus 'j ey s /'jəɨs/
iiia t r ii - 'aa /trɪː.'aː/
iiia (number) i - 'i - j a /ɪ.'ɪ.ja/
iimr ai - ai - e - 'm aa r /aɪ.aɪ.ɛ.'maːr/
ikbs ai - k ee - b ii - 'e s /aɪ.kɛː.bɪː.'ɛs/
ikebana (foreign) i - k e - 'b a - n a /ɪ.kɛ.'ba.na/
il 'i l /'ɪl/
il (foreign) 'i l /'ɪl/
ili 'i - l i /'ɪ.lɪ/
ilisu i - 'l ii - s y /ɪ.'lɪː.sɨ/
ilp ai - e l - 'p ii /aɪ.ɛl.'pɪː/
im&t ai - e - m a n d - 't ii /aɪ.ɛ.mand.'tɪː/
imaginet i - 'm a - jh i - n e t /ɪ.'ma.dʒɪ.nɛt/
immer (foreign) 'i - m e r /'ɪ.mɛr/
impresionistiaid (foreign) i m - p r e - sh o - 'n i s - t j ai d /ɪm.prɛ.ʃɔ.'nɪs.tjaɪd/
imwn 'i - m u n /'ɪ.mʊn/
indiaidd 'i n - d j ai dh /'ɪn.djaɪð/
inffyrmari (foreign) i n - f @ r - 'm a - r i /ɪn.fər.'ma.rɪ/
inis 'i - n i s /'ɪ.nɪs/
inizi (foreign) i - 'n i - z i /ɪ.'nɪ.zɪ/
injian (foreign) 'i n jh - j a n /'ɪndʒ.jan/
inna 'i - n a /'ɪ.na/
inne 'i - n e /'ɪ.nɛ/
innes 'i - n e s /'ɪ.nɛs/
institiwt i n s - 't i - t iu t /ɪns.'tɪ.tɪʊt/
institiwt (foreign) i n s - 't i - t iu t /ɪns.'tɪ.tɪʊt/
integreiddiedig i n - t e g - r ei dh - 'j ee - d i g /ɪn.tɛg.rəɪð.'jɛː.dɪg/
interreg (foreign) i n - t @ - 'r e g /ɪn.tə.'rɛg/
intyffirio (foreign) i n - t @ - 'f i r - j o /ɪn.tə.'fɪr.jɔ/
iodin (foreign) 'j oo - d i n /'jɔː.dɪn/
ioga 'j oo - g a /'jɔː.ga/
iogurt (foreign) 'j oo - g y r t /'jɔː.gɨrt/
iohannes j o - 'hh a - n e s /jɔ.'ha.nɛs/
irac 'i - r a k /'ɪ.rak/
iraniaid i - 'r a n - j ai d /ɪ.'ran.jaɪd/
irenaeus i - 'r e - 'n aay - y s /ɪ.'rɛ.'nɑɨ.ɨs/
ironig i - 'r o - n i g /ɪ.'rɔ.nɪg/
isa 'ii - s a /'ɪː.sa/
isbaal (foreign) 'i z - b 'ei @ l /'ɪz.b'əɪəl/
iscoed 'i s - k oy d /'ɪs.kɔɨd/
isfyd 'i s - v y d /'ɪs.vɨd/
isie (foreign) 'i - sh e /'ɪ.ʃɛ/
ismail 'i s - m ai l /'ɪs.maɪl/
israelaidd i s - 'r aay - l ai dh /ɪs.'rɑɨ.laɪð/
israeliaid (foreign) 'i s - r aay l - j ai d /'ɪs.rɑɨl.jaɪd/
israeliaid (foreign) i s - 'r aay l - j ai d /ɪs.'rɑɨl.jaɪd/
istanbwl i s - 't a n - b u l /ɪs.'tan.bʊl/
isycoed i - 's @ - k oy d /ɪ.'sə.kɔɨd/
itc ai - t ii - 's ii /aɪ.tɪː.'sɪː/
itec ai - 't e k /aɪ.'tɛk/
ith (foreign) 'ii th /'ɪːθ/
itn (foreign) 'i - t i n /'ɪ.tɪn/
ivor 'i - v o r /'ɪ.vɔr/
iwcrain 'iu k - r ai n /'ɪʊk.raɪn/
iwsio (foreign) 'iu - sh o /'ɪʊ.ʃɔ/
j 'jh ei /'dʒəɪ/
j (nmcy) 'jh ee /'dʒɛː/
jabas 'jh aa - b a s /'dʒaː.bas/
jabes (foreign) jh 'ei b z /dʒ'əɪbz/
jabi 'jh aa - b i /'dʒaː.bɪ/
jablonski jh a b - 'l o n s - k i /dʒab.'lɔns.kɪ/
jaco 'jh a - k o /'dʒa.kɔ/
jaffia (foreign) 'jh a f - j a /'dʒaf.ja/
jairiad (foreign) jh 'e r - j a d /dʒ'ɛr.jad/
jakez 'jh a - k e z /'dʒa.kɛz/
jarman 'jh a r - m a n /'dʒar.man/
jasmin 'jh a s - m i n /'dʒas.mɪn/
jcl jh ee - s ii - 'e l /dʒɛː.sɪː.'ɛl/
jean-pierre zh o n - p i - 'ee r /ʒɔn.pɪ.'ɛːr/
jeannine jh e - a - 'n i - n e /dʒɛ.a.'nɪ.nɛ/
jehosaffat jh e - hh o - 's aa - f a t /dʒɛ.hɔ.'saː.fat/
jeif (foreign) 'jh ei v /'dʒəɪv/
jel (foreign) 'jh e l /'dʒɛl/
jer 'jh e r /'dʒɛr/
jerahmeeliaid (foreign) jh '@r 'o m 'ii l - j ai d /dʒ'ər'ɔm'ɪːl.jaɪd/
jeriwsalem jh e - r iu - 's a - l e m /dʒɛ.rɪʊ.'sa.lɛm/
jesreel (foreign) jh 'e - zh r 'ii l /dʒ'ɛ.ʒr'ɪːl/
jigso (foreign) 'jh i g - s o /'dʒɪg.sɔ/
jigsô jh i g - 's oo /dʒɪg.'sɔː/
jijiga jh i - 'jh ii - g a /dʒɪ.'dʒɪː.ga/
jiw (foreign) 'jh iu /'dʒɪʊ/
jiwbili (foreign) jh iu - 'b i - l i /dʒɪʊ.'bɪ.lɪ/
jiwrasig jh iu - 'r aa - s i g /dʒɪʊ.'raː.sɪg/
jiwrasig (foreign) jh iu - 'r aa - s i g /dʒɪʊ.'raː.sɪg/
joab (foreign) jh 'ou b /dʒ'əʊb/
jobsus (foreign) 'jh o b - s y s /'dʒɔb.sɨs/
jocs (foreign) 'jh o k s /'dʒɔks/
joio (foreign) 'jh o - j o /'dʒɔ.jɔ/
joiwch 'jh o - j u x /'dʒɔ.jʊχ/
jones-evans 'jh ou n - 'z e - v a n s /'dʒəʊn.'zɛ.vans/
joni 'jh o - n i /'dʒɔ.nɪ/
jonni 'jh o - n i /'dʒɔ.nɪ/
jordi 'jh o r - d i /'dʒɔr.dɪ/
jos 'jh oo s /'dʒɔːs/
josepho jh o - 's e - f o /dʒɔ.'sɛ.fɔ/
jp jh ee - 'p ii /dʒɛː.'pɪː/
jungaidd 'jh y - ng ai dh /'dʒɨ.ŋaɪð/
jungiad 'jh y ng - j a d /'dʒɨŋ.jad/
jv (foreign) jh v /dʒv/
jwda 'jh uu - d a /'dʒʊː.da/
jwda (foreign) 'jh uu - d a /'dʒʊː.da/
jwdea jh u - 'd e - a /dʒʊ.'dɛ.a/
jwdeaid (foreign) 'jh uu - d e - ai d /'dʒʊː.dɛ.aɪd/
jwstus (foreign) jh u s - t y s /dʒʊs.tɨs/
jyrc (foreign) 'jh y r k /'dʒɨrk/
jên (foreign) 'jh ee n /'dʒɛːn/
jôcs 'jh oo k s /'dʒɔːks/
k 'k ei /'kəɪ/
k (nmcy) 'k ee /'kɛː/
kalashnikovs (foreign) k a - l a sh - 'n i - k o v s /ka.laʃ.'nɪ.kɔvs/
kalinnikov k a - l i - 'n i - k o v /ka.lɪ.'nɪ.kɔv/
kalmyk 'k a l - m y k /'kal.mɨk/
kalmykia k a l - 'm y k - j @ /kal.'mɨk.jə/
kamarin k a - 'm a - r i n /ka.'ma.rɪn/
karadog k a - 'r aa - d o g /ka.'raː.dɔg/
karamoja k a - r a - 'm o - jh a /ka.ra.'mɔ.dʒa/
karnag 'k a r - n a g /'kar.nag/
kay-shuttleworth k a - y - sh y t - 'l e - w o r th /ka.ɨ.ʃɨt.'lɛ.wɔrθ/
kebri 'k e b - r i /'kɛb.rɪ/
kellett 'k e - lh e t /'kɛ.ɬɛt/
kemper 'k e m - p e r /'kɛm.pɛr/
kesch 'k e s x /'kɛsχ/
keynesaidd k ey - 'n ee - s ai dh /kəɨ.'nɛː.saɪð/
kift 'k i f t /'kɪft/
kirkley 'k i r - k l ey /'kɪr.kləɨ/
kirkuk 'k i r - k y k /'kɪr.kɨk/
kleff 'k l ee f /'klɛːf/
klon 'k l o n /'klɔn/
knightley 'k n i g hh - t l ey /'knɪgh.tləɨ/
koreaid k o - 'r e - ai d /kɔ.'rɛ.aɪd/
koreaidd k o - 'r e - ai dh /kɔ.'rɛ.aɪð/
kossuth 'k o - s y th /'kɔ.sɨθ/
kotor 'k o - t o r /'kɔ.tɔr/
kournoussova k uu r - n uu - 's oo - v a /kʊːr.nʊː.'sɔː.va/
koutroubas k oy t - 'r oy - b a s /kɔɨt.'rɔɨ.bas/
kpr (foreign) k p r /kpr/
kraków k r a - 'k ou /kra.'kəʊ/
krief 'k r j ee v /'krjɛːv/
krätchmer 'k r a t - x m e r /'krat.χmɛr/
kurdiaid (foreign) 'k y r - d j ai d /'kɨr.djaɪd/
kwashiorkor (foreign) k w a sh - 'j o r - k o r /kwaʃ.'jɔr.kɔr/
kwiks (foreign) k w i k s /kwɪks/
kyffin 'k @ - f i n /'kə.fɪn/
kymer 'k @ - m e r /'kə.mɛr/
kynniver (foreign) k @ - 'n i - v e r /kə.'nɪ.vɛr/
l 'e l /'ɛl/
l'enfant 'l o n - f o n /'lɔn.fɔn/
l'histoire 'l ii s t - w aa r /'lɪːst.waːr/
labelau l a - 'b e - l ay /la.'bɛ.laɨ/
labrwrs (foreign) 'l a b - r u r s /'lab.rʊrs/
laddar (foreign) 'l aa - dh a r /'laː.ðar/
lagwn 'l aa - g u n /'laː.gʊn/
laker 'l a - k e r /'la.kɛr/
lampint 'l a m - p i n t /'lam.pɪnt/
landin 'l a n - d i n /'lan.dɪn/
landiodd (foreign) 'l a n - d j o dh /'lan.djɔð/
languag l a - 'ng y - a g /la.'ŋɨ.ag/
langue (foreign) l a - 'ng y - e /la.'ŋɨ.ɛ/
lanlord (foreign) 'l a n - l o r d /'lan.lɔrd/
laru 'l a - r y /'la.rɨ/
lasarus l a - 's a - r y s /la.'sa.rɨs/
lasiad (foreign) 'l a - sh a d /'la.ʃad/
latfiaid 'l a t - v j ai d /'lat.vjaɪd/
laurenco l ay - 'r e ng - k o /laɨ.'rɛŋ.kɔ/
lavernock l a - 'v e r - n o k /la.'vɛr.nɔk/
lavinia l a - 'v i n - j a /la.'vɪn.ja/
lawar (foreign) 'l a - w a r /'la.war/
lawgoch 'l au - g o x /'laʊ.gɔχ/
lawnaf 'l au - n a v /'laʊ.nav/
lawnsio 'l au n - sh o /'laʊn.ʃɔ/
lawnsiwyd 'l au n - 's i - w y d /'laʊn.'sɪ.wɨd/
lawrlwytho l au r - 'l uy - th o /laʊr.'lʊɨ.θɔ/
lawrlwythwch 'l au r - 'l uy - th u x /'laʊr.'lʊɨ.θʊχ/
layard l a - @ - a r d /la.ə.ard/
lc l k /lk/
ldr e l - d ii - 'aa r /ɛl.dɪː.'aːr/
lea-wilson 'l e - a - 'w i l - s o n /'lɛ.a.'wɪl.sɔn/
leanne 'l ii - n e /'lɪː.nɛ/
leavis l e - 'a - v i s /lɛ.'a.vɪs/
lecio (foreign) 'l e k - j o /'lɛk.jɔ/
ledio 'l e d - j o /'lɛd.jɔ/
leekes 'l ii k s /'lɪːks/
lefiad (foreign) 'l e v - j a d /'lɛv.jad/
lefiticus l e - v i - 't i - k y s /lɛ.vɪ.'tɪ.kɨs/
legis 'l e - jh i s /'lɛ.dʒɪs/
leibnitz 'l ei b - n i t z /'ləɪb.nɪtz/
leisydd 'l ei - s @ dh /'ləɪ.səð/
lench (foreign) l 'e n ch /l'ɛntʃ/
lengua 'l e ng - w @ /'lɛŋ.wə/
lenguas 'l e ng - w a s /'lɛŋ.was/
lenz (foreign) 'l e n z /'lɛnz/
leoleiddio l e - o - 'l ei dh - j o /lɛ.ɔ.'ləɪð.jɔ/
leptocephalii (foreign) l e p - t o - k e - 'f a - l ii /lɛp.tɔ.kɛ.'fa.lɪː/
leta 'l e - t a /'lɛ.ta/
levesque l e - 'v e s - k e /lɛ.'vɛs.kɛ/
lewcemia (foreign) l eu - 'k e m - j a /lɛʊ.'kɛm.ja/
lewis-jones 'l e - w i s - 'jh ou n z /'lɛ.wɪs.'dʒəʊnz/
lhwyd 'l hh uy d /'lhʊɨd/
lias 'l j aa s /'ljaːs/
libre (foreign) 'l i b - r e /'lɪb.rɛ/
lingen 'l i - ng e n /'lɪ.ŋɛn/
linguistique (foreign) l i - ng y - i s - 't i - k e /lɪ.ŋɨ.ɪs.'tɪ.kɛ/
lingüística l ii ng - g u - 'i s - t i - k a /lɪːŋ.gʊ.'ɪs.tɪ.ka/
lingüística (adjf) m a r - 'g ai - o x t /mar.'gaɪ.ɔχt/
linkline 'l i ng - k l ai n /'lɪŋ.klaɪn/
lisabeth l i - 's aa - b e th /lɪ.'saː.bɛθ/
lischana l i s - 'x a - n a /lɪs.'χa.na/
lisi 'l ii - s i /'lɪː.sɪ/
littlemore l i t - l e - 'm o - r e /lɪt.lɛ.'mɔ.rɛ/
liwsi 'l iu - s i /'lɪʊ.sɪ/
ll11 e lh - yy - n a r - 'dh ee g /ɛɬ.ɨː.nar.'ðɛːg/
llafuryddion lh a - v y - 'r @ dh - j o n /ɬa.vɨ.'rəð.jɔn/
llandarcy lh a n - 'd a r - k y /ɬan.'dar.kɨ/
llandâf lh a n - 'd aa v /ɬan.'daːv/
llanerchaeron lh a - n e r - 'x aay - r o n /ɬa.nɛr.'χɑɨ.rɔn/
llanfairynghornwy lh a n - v ai - 'r @ ng hh o r - n uy /ɬan.vaɪ.'rəŋhɔr.nʊɨ/
llangolwyn lh a n - 'g o - l uy n /ɬan.'gɔ.lʊɨn/
llangywair lh a n - 'g @ - w ai r /ɬan.'gə.waɪr/
llanllwchaiarn lh a n - lh u - 'x ai - a r n /ɬan.ɬʊ.'χaɪ.arn/
llanllyr 'lh a n - lh y r /'ɬan.ɬɨr/
llannerchirfon lh a n - n e r - 'x i r - v o n /ɬan.nɛr.'χɪr.vɔn/
llanwyddalus lh a - n uy - 'dh a - l y s /ɬa.nʊɨ.'ða.lɨs/
llawar (foreign) 'lh a - w a r /'ɬa.war/
llawfeddygon lh au - v e - 'dh @ - g o n /ɬaʊ.vɛ.'ðə.gɔn/
llawnach 'lh au - n a x /'ɬaʊ.naχ/
llawnaf 'lh au - n a v /'ɬaʊ.nav/
llay lh a - y /ɬa.ɨ/
llcc lh k /ɬk/
lle'r 'lh e r /'ɬɛr/
lleddaist 'lh ee - dh ai s t /'ɬɛː.ðaɪst/
lleddir 'lh ee - dh i r /'ɬɛː.ðɪr/
lleianod lh e - 'j a - n o d /ɬɛ.'ja.nɔd/
lleihau'r 'lh ei - hh ay r /'ɬəɪ.haɨr/
llengwr 'lh e - ng u r /'ɬɛ.ŋʊr/
llenoriaeth (foreign) lh e - 'n o r - j aay th /ɬɛ.'nɔr.jɑɨθ/
lleo 'lh e - o /'ɬɛ.ɔ/
lleshad 'lh e - sh a d /'ɬɛ.ʃad/
llethwyd 'lh ee - th uy d /'ɬɛː.θʊɨd/
llety-bugel 'lh e - t y - 'b yy - g e l /'ɬɛ.tɨ.'bɨː.gɛl/
llewlyn 'lh eu - l y n /'ɬɛʊ.lɨn/
llewod 'lh e - w o d /'ɬɛ.wɔd/
llewod (foreign) 'lh e - w o d /'ɬɛ.wɔd/
lleyn 'lh ey n /'ɬəɨn/
llnau 'lh n ay /'ɬnaɨ/
llnau (foreign) 'lh n ay /'ɬnaɨ/
llonga 'lh o - ng a /'ɬɔ.ŋa/
llosgachol lh o s - 'k aa - x o l /ɬɔs.'kaː.χɔl/
llsgr lh s k r /ɬskr/
lluis 'lh uy s /'ɬʊɨs/
llunden 'lh y n - d e n /'ɬɨn.dɛn/
llur (foreign) 'lh y r /'ɬɨr/
llwchyn (foreign) 'lh uu - x y n /'ɬʊː.χɨn/
llwon lh w o n /ɬwɔn/
llwynogod lh uy - 'n oo - g o d /ɬʊɨ.'nɔː.gɔd/
llwynogod (foreign) 'lh uy - n o g o d /'ɬʊɨ.nɔgɔd/
llwyrach 'lh uy - r a x /'ɬʊɨ.raχ/
llydanwyrdd lh @ - 'd a - n uy r dh /ɬə.'da.nʊɨrð/
llydawyr lh @ - 'd a - w y r /ɬə.'da.wɨr/
llyffantod lh @ - 'f a n - t o d /ɬə.'fan.tɔd/
llyfre 'lh @ v - r e /'ɬəv.rɛ/
llyfre (foreign) 'lh @ v - r e /'ɬəv.rɛ/
llymach 'lh @ - m a x /'ɬə.maχ/
llymriaid 'lh @ m - r j ai d /'ɬəm.rjaɪd/
llynnon 'lh @ - n o n /'ɬə.nɔn/
llythur (foreign) 'lh @ - th y r /'ɬə.θɨr/
llywelyn- lh @ - 'w e - l y n /ɬə.'wɛ.lɨn/
llywelyn-williams lh @ - 'w e - l y n - 'w i lh - j a m s /ɬə.'wɛ.lɨn.'wɪɬ.jams/
lms e - l e - 'm e s /ɛ.lɛ.'mɛs/
longstanton l o ng s - 't a n - t o n /lɔŋs.'tan.tɔn/
lorenza l o - 'r e n - z @ /lɔ.'rɛn.zə/
lorwerth 'l o r - w e r th /'lɔr.wɛrθ/
lotments (foreign) 'l o t - m e n t s /'lɔt.mɛnts/
lottie 'l o t - j e /'lɔt.jɛ/
lpm e l - p ii - 'e m /ɛl.pɪː.'ɛm/
lsb e - l e s - 'b ii /ɛ.lɛs.'bɪː/
lsi e - l e - 's ai /ɛ.lɛ.'saɪ/
luimneach l y - i m - 'n e - a x /lɨ.ɪm.'nɛ.aχ/
lukes 'l y - k e s /'lɨ.kɛs/
lunden 'l y n - d e n /'lɨn.dɛn/
luv (foreign) 'l y v /'lɨv/
lycaonia (foreign) 'l @ - 'k a - o n - j a /'lə.'ka.ɔn.ja/
lâc 'l aa k /'laːk/
lês 'l ee s /'lɛːs/
lês (foreign) 'l ee s /'lɛːs/
m 'e m /'ɛm/
m/a e - 'm aa /ɛ.'maː/
mabinogion (foreign) m a - b i - 'n o g - j o n /ma.bɪ.'nɔg.jɔn/
mabirocion m a - b i - 'r o k - j o n /ma.bɪ.'rɔk.jɔn/
macdonalds (foreign) m a k - 'd o - n a l d s /mak.'dɔ.nalds/
macedoniaid (foreign) m a - k e - 'd o n - j ai d /ma.kɛ.'dɔn.jaɪd/
macfarlane m a k - v a r - 'l a - n e /mak.var.'la.nɛ/
macquarrie m a k - 'w a r - j e /mak.'war.jɛ/
macrocosmos (foreign) m a k - r o - 'k o s - m o s /mak.rɔ.'kɔs.mɔs/
madelen m a - 'd e - l e n /ma.'dɛ.lɛn/
madoc 'm aa - d o k /'maː.dɔk/
madriaid 'm a d - r j ai d /'mad.rjaɪd/
maelon 'm aay - l o n /'mɑɨ.lɔn/
maesb 'm aay s p /'mɑɨsp/
maesgwyn 'm aay s - k uy n /'mɑɨs.kʊɨn/
maesincla m aay - 's i ng - k l a /mɑɨ.'sɪŋ.kla/
maesisalaw m aay - s i - 's a - l au /mɑɨ.sɪ.'sa.laʊ/
maesmochnant m aay s - 'm o x - n a n t /mɑɨs.'mɔχ.nant/
maesydre m aay - 's @ d - r e /mɑɨ.'səd.rɛ/
maesywaen 'm aay - 's @ - w aay n /'mɑɨ.'sə.wɑɨn/
maf e - m ee - 'e f /ɛ.mɛː.'ɛf/
magnwm 'm a g - n u m /'mag.nʊm/
magwen 'm a g - w e n /'mag.wɛn/
mai'r 'm ai r /'maɪr/
mailback 'm ei l - b a k /'məɪl.bak/
mailto 'm ei l - t uu /'məɪl.tʊː/
mainwaring m ai n - 'w a - r i ng /maɪn.'wa.rɪŋ/
malcym 'm a l - k y m /'mal.kɨm/
maletas (foreign) m a - 'l e - t a s /ma.'lɛ.tas/
mallorca m a - 'lh o r - k a /ma.'ɬɔr.ka/
malltwen 'm a lh t - w e n /'maɬt.wɛn/
malvinas m a l - 'v i - n a s /mal.'vɪ.nas/
mamgu 'm a m - g y /'mam.gɨ/
mami (foreign) 'm a - m i /'ma.mɪ/
manaf 'm a - n a v /'ma.nav/
mandri 'm a n - d r i /'man.drɪ/
mangre 'm a ng - r e /'maŋ.rɛ/
manwerthwyr m a n - 'w e r - th uy r /man.'wɛr.θʊɨr/
manylach m a - 'n @ - l a x /ma.'nə.laχ/
manyldra m a - 'n @ l - d r a /ma.'nəl.dra/
manyldra'r (foreign) m a - 'n @ l - d r a r /ma.'nəl.drar/
marchwiel m a r - 'x u - j e l /mar.'χʊ.jɛl/
maredydd m a - 'r ee - d y dh /ma.'rɛː.dɨð/
marjarîn (foreign) m a r - jh a - 'r ii n /mar.dʒa.'rɪːn/
markale m a r - 'k a - l e /mar.'ka.lɛ/
marknadsfring 'm a r k - n a d z - f r i ng /'mark.nadz.frɪŋ/
marknadsföring 'm a r k - n a d - z f @@ - r i ng /'mark.nad.zfɜː.rɪŋ/
marles 'm a r - l e s /'mar.lɛs/
marprelate (foreign) m a r - p r e - 'l a - t e /mar.prɛ.'la.tɛ/
marti 'm a r - t i /'mar.tɪ/
martin-jones 'm a r - t i n - 'jh ou n z /'mar.tɪn.'dʒəʊnz/
marwgofion m a - r u - 'g o v - j o n /ma.rʊ.'gɔv.jɔn/
marîn m a - 'r ii n /ma.'rɪːn/
masaryk m a - 's a - r y k /ma.'sa.rɨk/
mascanosa m a s - k a - 'n oo - s a /mas.ka.'nɔː.sa/
masgot (foreign) 'm a s - k o t /'mas.kɔt/
mastia 'm a s - t j a /'mas.tja/
mati 'm a - t i /'ma.tɪ/
matsian 'm a - ch a n /'ma.tʃan/
matsys 'm a - ch @ s /'ma.tʃəs/
mattoidz 'm a - t oi d z /'ma.tɔɪdz/
mau 'm ay /'maɨ/
maulvi (foreign) 'm ay l - v i /'maɨl.vɪ/
maurras 'm ay - r a s /'maɨ.ras/
maury 'm ay - r y /'maɨ.rɨ/
mawndir 'm au n - d i r /'maʊn.dɪr/
mazzini m a - 'z i - n i /ma.'zɪ.nɪ/
mcbryde 'm k b r @ - d e /'mkbrə.dɛ/
mcc e m - s ii - 's ii /ɛm.sɪː.'sɪː/
mcluhan 'm k l y - hh a n /'mklɨ.han/
mcneir m @ k - 'n ii r /mək.'nɪːr/
mdb e m - d ii - 'b ii /ɛm.dɪː.'bɪː/
mecanic (foreign) m e - 'k a - n i k /mɛ.'ka.nɪk/
mecanicia (foreign) m e - k a - 'n i k - j a /mɛ.ka.'nɪk.ja/
medde 'm ee - dh e /'mɛː.ðɛ/
meddygon m e - 'dh @ - g o n /mɛ.'ðə.gɔn/
medrawd 'm e d - r au d /'mɛd.raʊd/
medren 'm e d - r e n /'mɛd.rɛn/
medrusaf m e d - 'r yy - s a v /mɛd.'rɨː.sav/
meghalaya m e g - 'hh a - l a - @ - a /mɛg.'ha.la.ə.a/
megys (foreign) 'm ee - g y s /'mɛː.gɨs/
meicrodon m ei k - 'r oo - d o n /məɪk.'rɔː.dɔn/
meindar (foreign) 'm ei n - d a r /'məɪn.dar/
meindars (foreign) 'm ei n - d a r s /'məɪn.dars/
meinjar (foreign) 'm ei n - jh a r /'məɪn.dʒar/
meir (foreign) 'm ei r /'məɪr/
meira 'm ei - r a /'məɪ.ra/
meistraidd 'm ei s - t r ai dh /'məɪs.traɪð/
meithach 'm ei - th a x /'məɪ.θaχ/
mem 'm e m /'mɛm/
mencap (foreign) 'm e ng - k a p /'mɛŋ.kap/
mene (foreign) 'm e - n e /'mɛ.nɛ/
menem 'm e - n e m /'mɛ.nɛm/
mengistu m e - 'ng i s - t y /mɛ.'ŋɪs.tɨ/
menyg 'm e - n y g /'mɛ.nɨg/
merab (foreign) m 'e - r @ b /m'ɛ.rəb/
merchaid 'm e r - x ai d /'mɛr.χaɪd/
merchaid (foreign) 'm e r - x ai d /'mɛr.χaɪd/
merffordd 'm e r - f o r dh /'mɛr.fɔrð/
merllynnod (foreign) 'm e r - lh @ - n o d /'mɛr.ɬə.nɔd/
mersi 'm e r - s i /'mɛr.sɪ/
merswy 'm e r - s uy /'mɛr.sʊɨ/
merêd m e - 'r ee d /mɛ.'rɛːd/
mesianaidd m e - 'sh a - n ai dh /mɛ.'ʃa.naɪð/
mesianaidd (foreign) m e - 'sh a - n ai dh /mɛ.'ʃa.naɪð/
messerschmitt m e - 's e r s - x m i t /mɛ.'sɛrs.χmɪt/
metalau m e - 't a - l ay /mɛ.'ta.laɨ/
metcalf 'm e t - k aa f /'mɛt.kaːf/
metcalfe 'm e t - k aa f /'mɛt.kaːf/
methodus m e - 'th oo - d y s /mɛ.'θɔː.dɨs/
metropole m e t - r o - 'p o - l e /mɛt.rɔ.'pɔ.lɛ/
meu 'm ey /'məɨ/
meurug 'm ey - r y g /'məɨ.rɨg/
meurwyn 'm ey - r uy n /'məɨ.rʊɨn/
mewngofnodwch m eu - ng o v - 'n oo - d u x /mɛʊ.ŋɔv.'nɔː.dʊχ/
meyrick 'm ey - r i k /'məɨ.rɪk/
mf (foreign) m v /mv/
mhenybont mh e - 'n @ - b o n t /mɛ.'nə.bɔnt/
mhlasdŷ (foreign) 'mh l aa s 'd yy /'mlaːs'dɨː/
mhysan (foreign) 'mh @ - s a n /'mə.san/
micr e - m ai - s ii - 'aa r /ɛ.maɪ.sɪː.'aːr/
microscop m i k - 'r o s - k o p /mɪk.'rɔs.kɔp/
midha 'm i - d @ /'mɪ.də/
midmore m i d - 'm o - r e /mɪd.'mɔ.rɛ/
mif e - m ai - 'e f /ɛ.maɪ.'ɛf/
migron (foreign) m 'ai - g r o n /m'aɪ.grɔn/
mildmay 'm i l d - m a - y /'mɪld.ma.ɨ/
milfeddygon m i l - v e - 'dh @ - g o n /mɪl.vɛ.'ðə.gɔn/
militaraidd m i - l i - 't a - r ai dh /mɪ.lɪ.'ta.raɪð/
millace m i - 'lh a - k e /mɪ.'ɬa.kɛ/
mim e - m ai - 'e m /ɛ.maɪ.'ɛm/
mineralau (foreign) m i - n e - 'r a - l ay /mɪ.nɛ.'ra.laɨ/
mingay (foreign) m 'i ng - g 'ei /m'ɪŋ.g'əɪ/
minicom 'm i - n i - k o m /'mɪ.nɪ.kɔm/
miniocaf m i n - 'j o - k a v /mɪn.'jɔ.kav/
minna 'm i - n a /'mɪ.na/
minoritarias m i - n o - r i - 't aa - r i - a s /mɪ.nɔ.rɪ.'taː.rɪ.as/
mionlaigh 'm ii - o n - l ei /'mɪː.ɔn.ləɪ/
mirabent 'm i - r @ - b e n t /'mɪ.rə.bɛnt/
mishtir (foreign) 'm i sh - t i r /'mɪʃ.tɪr/
missell 'm i - s @ l /'mɪ.səl/
mistar (foreign) 'm i s - t a r /'mɪs.tar/
mistir (foreign) 'm i s - t i r /'mɪs.tɪr/
misus (foreign) 'm ii - s y s /'mɪː.sɨs/
mlc m l k /mlk/
mochal (foreign) 'm oo - x a l /'mɔː.χal/
modernismo (foreign) m o - d e r - 'n i s - m o /mɔ.dɛr.'nɪs.mɔ/
modurol m o - 'd y - r o l /mɔ.'dɨ.rɔl/
moelyn 'm oy - l y n /'mɔɨ.lɨn/
moes 'm oy s /'mɔɨs/
mojo 'm o - jh o /'mɔ.dʒɔ/
molchi 'm o l - x i /'mɔl.χɪ/
moltmann 'm o l t - m a n /'mɔlt.man/
monde (foreign) 'm o n - d e /'mɔn.dɛ/
moniwment (foreign) m o - 'n iu - m e n t /mɔ.'nɪʊ.mɛnt/
mons (foreign) m @ n z /mənz/
morfilod m o r - 'v i - l o d /mɔr.'vɪ.lɔd/
morganus m o r - 'g a - n y s /mɔr.'ga.nɨs/
morganwg m o r - 'g a - n u g /mɔr.'ga.nʊg/
moriah 'm o r - j a hh /'mɔr.jah/
mormile 'm o a - m ai l /'mɔa.maɪl/
morovietz m o - 'r o v - j e t z /mɔ.'rɔv.jɛtz/
morris-jones 'm o - r i s - 'jh ou n z /'mɔ.rɪs.'dʒəʊnz/
moslemaidd m o s - 'l e - m ai dh /mɔs.'lɛ.maɪð/
moslemiaeth m o s - 'l e m - j aay th /mɔs.'lɛm.jɑɨθ/
moslemiaid m o s - 'l e m - j ai d /mɔs.'lɛm.jaɪd/
moto (foreign) 'm o - t o /'mɔ.tɔ/
motobeic m o - 't oo - b ei k /mɔ.'tɔː.bəɪk/
motos (foreign) 'm o - t o s /'mɔ.tɔs/
mouches 'm uu sh /'mʊːʃ/
mouhot 'm oy - hh o t /'mɔɨ.hɔt/
movie 'm uu - v i /'mʊː.vɪ/
movies 'm uu - v i z /'mʊː.vɪz/
moyn 'm oy n /'mɔɨn/
moyn (foreign) 'm oy n /'mɔɨn/
mpac e m - p ii - aa - 'e k /ɛm.pɪː.aː.'ɛk/
msapi e m - 's a p - i /ɛm.'sap.ɪ/
msb e - m e s - 'b ii /ɛ.mɛs.'bɪː/
mth m th /mθ/
muallt 'm y - a lh t /'mɨ.aɬt/
mulod 'm y - l o d /'mɨ.lɔd/
mulroney m y l - 'r o - n ey /mɨl.'rɔ.nəɨ/
multicorpora 'm @ l - t i - k o a - p @ - r @ /'məl.tɪ.kɔa.pə.rə/
musus (foreign) 'm yy - s y s /'mɨː.sɨs/
mv m e - g a - 'v o l t /mɛ.ga.'vɔlt/
mwmbwls 'm u m - b u l s /'mʊm.bʊls/
mwsi 'm uu - s i /'mʊː.sɪ/
mwsog 'm uu - s o g /'mʊː.sɔg/
mwstardd (foreign) 'm u s - t a r dh /'mʊs.tarð/
mwyndera m uy n - 'd e - r a /mʊɨn.'dɛ.ra/
mwynhau'r 'm uy n hh ay r /'mʊɨnhaɨr/
mym 'm y m /'mɨm/
mym (foreign) 'm y m /'mɨm/
mympwyon 'm @ m - 'p uy - o n /'məm.'pʊɨ.ɔn/
mynachod m @ - 'n aa - x o d /mə.'naː.χɔd/
mynychu'r m @ - 'n @ - x y r /mə.'nə.χɨr/
mâs 'm aa s /'maːs/
mölln 'm o lh n /'mɔɬn/
münster 'm y n s - t e r /'mɨns.tɛr/
mŵd 'm uu d /'mʊːd/
n 'e n /'ɛn/
n-og 'n oo g /'nɔːg/
n/a e - 'n ee /ɛ.'nɛː/
nabal (foreign) n 'ei - b @ l /n'əɪ.bəl/
nacia (foreign) 'n a k - j a /'nak.ja/
nadreddog n a d - 'r ee - dh o g /nad.'rɛː.ðɔg/
naferyn n a - 'v e - r y n /na.'vɛ.rɨn/
namotto n a - 'm o - t o /na.'mɔ.tɔ/
nanconwy n a ng - 'k o - n uy /naŋ.'kɔ.nʊɨ/
nansen 'n a n - s e n /'nan.sɛn/
nantmelyn n a n t - 'm e - l y n /nant.'mɛ.lɨn/
nantygorlan n a n - t @ - 'g o r - l a n /nan.tə.'gɔr.lan/
napoleonaidd (foreign) n @ - p 'ou - l ii - @ - n ai dh /nə.p'əʊ.lɪː.ə.naɪð/
naratifau n a - r a - 't ii - v ay /na.ra.'tɪː.vaɨ/
narfon 'n a r - v o n /'nar.vɔn/
nashe 'n a - sh e /'na.ʃɛ/
nasuwt e - n ee - e - s iu - d @ b - l iu - 't ii /ɛ.nɛː.ɛ.sɪʊ.dəb.lɪʊ.'tɪː/
nat (foreign) 'n a t /'nat/
nath 'n aa th /'naːθ/
nath (foreign) 'n aa th /'naːθ/
natsiaid 'n a - ch ai d /'na.tʃaɪd/
nawddsantes n au dh - 's a n - t e s /naʊð.'san.tɛs/
ncvq ng k v k /ŋkvk/
neddig 'n ee - dh i g /'nɛː.ðɪg/
nefer (foreign) 'n ee - v e r /'nɛː.vɛr/
neffeg (foreign) 'n ee - f e g /'nɛː.fɛg/
negas (foreign) 'n ee - g a s /'nɛː.gas/
negba 'n e g - b a /'nɛg.ba/
negef (foreign) n e - 'g ee - v /nɛ.'gɛː.v/
neglectedno (foreign) n @ - g l 'e k - t @ d - n o /nə.gl'ɛk.təd.nɔ/
negydu n e - 'g @ - d y /nɛ.'gə.dɨ/
neillduol n ei lh - 'd y - o l /nəɪɬ.'dɨ.ɔl/
neillduol (foreign) n ei lh - 'd y - o l /nəɪɬ.'dɨ.ɔl/
neli 'n e - l i /'nɛ.lɪ/
nemawr (foreign) 'n e - m au r /'nɛ.maʊr/
nene (foreign) 'n e - n e /'nɛ.nɛ/
nennius 'n e - n i - y s /'nɛ.nɪ.ɨs/
neo-natsïaid 'n e - o - n a - 'ch i - ai d /'nɛ.ɔ.na.'tʃɪ.aɪd/
neris 'n e - r i s /'nɛ.rɪs/
netin (foreign) 'n e - t i n /'nɛ.tɪn/
netwales 'n e t - w ee l z /'nɛt.wɛːlz/
neu'n n ey n /nəɨn/
neu'r n ey r /nəɨr/
nevill 'n e - v i lh /'nɛ.vɪɬ/
newcombe 'n iu - k @ m /'nɪʊ.kəm/
newcomen (foreign) n eu - 'k o - m e n /nɛʊ.'kɔ.mɛn/
newyddfyd n e - 'w @ dh - v y d /nɛ.'wəð.vɨd/
nexin 'n e k s i n /'nɛksɪn/
nfer e - n e - f ii - 'aa r /ɛ.nɛ.fɪː.'aːr/
ngenefa (foreign) ng e - 'n ee - v a /ŋɛ.'nɛː.va/
ngfl e n - jh ii - e f - 'e l /ɛn.dʒɪː.ɛf.'ɛl/
ngh e ng - 'hh aay ch /ɛŋ.'hɑɨtʃ/
ngharno 'ngh a r - n o /'ŋ̊ar.nɔ/
nghorinth (foreign) 'ngh o r 'ai n th /'ŋ̊ɔr'aɪnθ/
nghymru’r (foreign) 'ngh @ m - r y r /'ŋ̊əm.rɨr/
nghyngrair 'ngh @ ng - r ai r /'ŋ̊əŋ.raɪr/
ngwyneb 'ng w @ - n e b /'ŋwə.nɛb/
nh nh /n̥/
nhrefarthen (foreign) nh r e - 'v a r - th e n /n̥rɛ.'var.θɛn/
nhregwyr 'nh r ee - g uy r /'n̥rɛː.gʊɨr/
nhw'n 'nh uu n /'n̥ʊːn/
nhwtha 'nh uu - th a /'n̥ʊː.θa/
nhwtha (foreign) 'nh uu - th a /'n̥ʊː.θa/
nhy 'nh yy /'n̥ɨː/
ni'n 'n i n /'nɪn/
niace 'n ai - ee s /'naɪ.ɛːs/
nipon 'n i - p o n /'nɪ.pɔn/
nirfana (foreign) n i r - 'v a - n a /nɪr.'va.na/
nishen 'n i - sh e n /'nɪ.ʃɛn/
niwcliar 'n iu k - l j a r /'nɪʊk.ljar/
niwro 'n iu - r o /'nɪʊ.rɔ/
nmi e - n e - 'm ai /ɛ.nɛ.'maɪ/
noa 'n o - a /'nɔ.a/
nodi'r 'n oo - d i r /'nɔː.dɪr/
noethlwm 'n oy th - l u m /'nɔɨθ.lʊm/
nog 'n oo g /'nɔːg/
nolini n o - 'l i - n i /nɔ.'lɪ.nɪ/
nom 'n o m /'nɔm/
nop e - n oo - 'p ii /ɛ.nɔː.'pɪː/
nore 'n o - r e /'nɔ.rɛ/
normalització n o r - m a - l i t - 'z a th - j o /nɔr.ma.lɪt.'zaθ.jɔ/
normandi n o r - 'm a n - d i /nɔr.'man.dɪ/
northover 'n o r - th oo - v @ /'nɔr.θɔː.və/
noseas (foreign) n o - 's e - a s /nɔ.'sɛ.as/
notis (foreign) 'n o - t i s /'nɔ.tɪs/
notts 'n o t s /'nɔts/
nowa 'n o - w a /'nɔ.wa/
nowel 'n o - w e l /'nɔ.wɛl/
nowell 'n o - w e lh /'nɔ.wɛɬ/
npv e n - p ii - 'v ii /ɛn.pɪː.'vɪː/
nte 'n t ee /'ntɛː/
num 'n y m /'nɨm/
numeri (foreign) n y - 'm e - r i /nɨ.'mɛ.rɪ/
nuras (foreign) 'n y - r a s /'nɨ.ras/
nwyon 'n uy - o n /'nʊɨ.ɔn/
nyrsus 'n @ r - s y s /'nər.sɨs/
nythle 'n @ th - l e /'nəθ.lɛ/
nythod 'n @ - th o d /'nə.θɔd/
o'ch ou x /əʊχ/
o'henley ou - 'hh e n - l i /əʊ.'hɛn.lɪ/
oa oo - 'aa /ɔː.'aː/
oakeley o - a - 'k e - l ey /ɔ.a.'kɛ.ləɨ/
oberwart o - 'b e r - w a r t /ɔ.'bɛr.wart/
obiti (foreign) o - 'b i - t i /ɔ.'bɪ.tɪ/
odano o - 'd a - n o /ɔ.'da.nɔ/
oddiwrth 'oo - dh iu r th /'ɔː.ðɪʊrθ/
oddiwrth (foreign) 'oo - dh iu r th /'ɔː.ðɪʊrθ/
ododd 'oo - d o dh /'ɔː.dɔð/
oeddach 'oy - dh a x /'ɔɨ.ðaχ/
oeddan 'oy - dh a n /'ɔɨ.ðan/
oeddan (foreign) 'oy - dh a n /'ɔɨ.ðan/
oeddat (foreign) 'oy - dh a t /'ɔɨ.ðat/
oedfaon oy d - 'v a - o n /ɔɨd.'va.ɔn/
oedoliaeth oy - 'd o l - j aay th /ɔɨ.'dɔl.jɑɨθ/
oerwaed 'oy r - w aay d /'ɔɨr.wɑɨd/
oet 'oy t /'ɔɨt/
offical @ - 'f i - sh @ l /ə.'fɪ.ʃəl/
offis (foreign) 'oo - f i s /'ɔː.fɪs/
ofice 'o - f i s /'ɔ.fɪs/
ofis 'o - f i s /'ɔ.fɪs/
ogilby o - 'g i l - b y /ɔ.'gɪl.bɨ/
ogmore o g - 'm o - r e /ɔg.'mɔ.rɛ/
ohmci oo - ee - ch e m - s ii - 'ai /ɔː.ɛː.tʃɛm.sɪː.'aɪ/
ohona o - 'hh o - n a /ɔ.'hɔ.na/
ohonaw (foreign) o - 'hh o - n au /ɔ.'hɔ.naʊ/
ohoni’n (foreign) o - hh o - n i n /ɔ.hɔ.nɪn/
ohonno o - 'hh o - n o /ɔ.'hɔ.nɔ/
oidipos oi - 'd i - p o s /ɔɪ.'dɪ.pɔs/
oireachtas 'oi - r e x - t @ s /'ɔɪ.rɛχ.təs/
ol 'o l /'ɔl/
ol (foreign) 'o l /'ɔl/
ola 'o - l a /'ɔ.la/
olgra 'o l - g r a /'ɔl.gra/
olifer o - 'l ii - v e r /ɔ.'lɪː.vɛr/
olivetan o - l i - 'v e - t a n /ɔ.lɪ.'vɛ.tan/
olly 'o - l i /'ɔ.lɪ/
olygedig o - l @ - 'g ee - d i g /ɔ.lə.'gɛː.dɪg/
onibai o - 'n ii - b ai /ɔ.'nɪː.baɪ/
oop 'uu p /'ʊːp/
operasiwn (foreign) o - p e - 'r aa - s iu n /ɔ.pɛ.'raː.sɪʊn/
operau o - 'p e - r ay /ɔ.'pɛ.raɨ/
optegyddion o p - t e - 'g @ dh - j o n /ɔp.tɛ.'gəð.jɔn/
orbis (foreign) 'o r - b i s /'ɔr.bɪs/
ordovicis (foreign) o r - d o - 'v i - k i s /ɔr.dɔ.'vɪ.kɪs/
ordro (foreign) 'o r - d r o /'ɔr.drɔ/
oreu 'o - r ey /'ɔ.rəɨ/
oreu (foreign) 'o - r ey /'ɔ.rəɨ/
orffan (foreign) 'o r - f a n /'ɔr.fan/
org 'o r g /'ɔrg/
oria 'o r - j a /'ɔr.ja/
orita (foreign) o - 'r i - t a /ɔ.'rɪ.ta/
ortelius o r - 't e - l i - y s /ɔr.'tɛ.lɪ.ɨs/
orumiyeh o - 'r y - m i - @ - e hh /ɔ.'rɨ.mɪ.ə.ɛh/
osa 'oo - s a /'ɔː.sa/
oswyn 'oo - s uy n /'ɔː.sʊɨn/
otograff o - 't o g - r a f /ɔ.'tɔg.raf/
otomatig o - t o - 'm a - t i g /ɔ.tɔ.'ma.tɪg/
ou (foreign) 'oy /'ɔɨ/
oundle 'oy n - d l e /'ɔɨn.dlɛ/
owa 'o - w a /'ɔ.wa/
owan 'o - w a n /'ɔ.wan/
owena o - 'w e - n a /ɔ.'wɛ.na/
owens 'o - w e n s /'ɔ.wɛns/
owertyn o - 'w e r - t y n /ɔ.'wɛr.tɨn/
owyr (foreign) 'o - w y r /'ɔ.wɨr/
oxo (foreign) 'o k s o /'ɔksɔ/
oxonienses (foreign) o k s o n - 'j e n - s e s /ɔksɔn.'jɛn.sɛs/
oxwich 'o k s w i x /'ɔkswɪχ/
o’m (foreign) o m /ɔm/
p 'p ii /'pɪː/
p'nawn 'p n au n /'pnaʊn/
pabyddes p a - 'b @ - dh e s /pa.'bə.ðɛs/
paentiwr 'p aay n - t iu r /'pɑɨn.tɪʊr/
pagninus p a g - 'n i - n y s /pag.'nɪ.nɨs/
palasdai p a - 'l a s - t ai /pa.'las.taɪ/
palembang p a - 'l e m - b a ng /pa.'lɛm.baŋ/
palepurple p ee l - 'p @@ - p @ l /pɛːl.'pɜː.pəl/
palesteina p a - l e s - 't ei - n a /pa.lɛs.'təɪ.na/
palesteinaidd p a - l e s - 't ei - n ai dh /pa.lɛs.'təɪ.naɪð/
palestiniaid p a - l e s - 't i n - j ai d /pa.lɛs.'tɪn.jaɪd/
pannenberg p a - 'n e n - b e r g /pa.'nɛn.bɛrg/
pantachddu p a n - 't a x - dh y /pan.'taχ.ðɨ/
pape 'p a - p e /'pa.pɛ/
parasitoed p a - r a - 's i - t oy d /pa.ra.'sɪ.tɔɨd/
parcelforce 'p a r - s @ l - f o a s /'par.səl.fɔas/
parchusaf p a r - 'x yy - s a v /par.'χɨː.sav/
parkhurst 'p a r k - hh y r s t /'park.hɨrst/
parrat (foreign) 'p a - r a t /'pa.rat/
parry-willams 'p a - r y - 'w i lh a m s /'pa.rɨ.'wɪɬams/
parry-williams 'p a - r y - 'w i lh - j a m s /'pa.rɨ.'wɪɬ.jams/
parsli 'p a r s - l i /'pars.lɪ/
pasej (foreign) 'p aa - s e jh /'paː.sɛdʒ/
pasport (foreign) 'p a s - p o r t /'pas.pɔrt/
pathetig p a - 'th e - t i g /pa.'θɛ.tɪg/
pathewod p a - 'th e - w o d /pa.'θɛ.wɔd/
patmos 'p a t - m o s /'pat.mɔs/
paton 'p a - t o n /'pa.tɔn/
pc/dos p ii - s ii - 'd o s /pɪː.sɪː.'dɔs/
pca p ii - s ii - 'ee /pɪː.sɪː.'ɛː/
pcc p ii - s ii - 's ii /pɪː.sɪː.'sɪː/
pcd p ii - s ii - 'd ii /pɪː.sɪː.'dɪː/
pdag 'p d aa g /'pdaːg/
pdh p d hh /pdh/
pdh (foreign) p d hh /pdh/
pearse p e - 'a r - s e /pɛ.'ar.sɛ/
peate p e - 'a - t e /pɛ.'a.tɛ/
peckham 'p e k - hh a m /'pɛk.ham/
peddie 'p e dh - j e /'pɛð.jɛ/
pedwarair 'p e d - w a r /'pɛd.war/
pegynu p e - 'g @ - n y /pɛ.'gə.nɨ/
pei (foreign) 'p ei /'pəɪ/
peilat (foreign) 'p ei - l a t /'pəɪ.lat/
peirianau p ei r - 'j a - n ay /pəɪr.'ja.naɨ/
pelagiaeth p e - 'l a g - j aay th /pɛ.'lag.jɑɨθ/
pelagiws p e - 'l aa - g iu s /pɛ.'laː.gɪʊs/
pella 'p e - lh a /'pɛ.ɬa/
pellai 'p e - lh ai /'pɛ.ɬaɪ/
pembertons p e m - 'b e r - t o n s /pɛm.'bɛr.tɔns/
pembrey 'p e m - b r ey /'pɛm.brəɨ/
pena 'p e - n a /'pɛ.na/
penarlag p e - 'n a r - l a g /pɛ.'nar.lag/
penbre 'p e n - b r e /'pɛn.brɛ/
pencawr 'p e ng - k au r /'pɛŋ.kaʊr/
pendaran p e n - 'd a - r a n /pɛn.'da.ran/
penderecki p e n - d e - 'r e - k i /pɛn.dɛ.'rɛ.kɪ/
penffordd 'p e n - f o r dh /'pɛn.fɔrð/
penhwyaden p e n hh uy - 'aa - d e n /pɛnhʊɨ.'aː.dɛn/
peninna (foreign) p @ - n 'i - n a /pə.n'ɪ.na/
penower (foreign) p 'e - n @ - w e r /p'ɛ.nə.wɛr/
penry 'p e n - r y /'pɛn.rɨ/
pensaerniaeth p e n - 's aay r - n j aay th /pɛn.'sɑɨr.njɑɨθ/
pensaerniol p e n - 's aay r - n j o l /pɛn.'sɑɨr.njɔl/
pentiriaeth p e n - 't i r - j aay th /pɛn.'tɪr.jɑɨθ/
pentra 'p e n - t r a /'pɛn.tra/
pentra (foreign) 'p e n - t r a /'pɛn.tra/
pentrebychan p e n - t r e - 'b @ - x a n /pɛn.trɛ.'bə.χan/
penuel p e - 'n y - e l /pɛ.'nɨ.ɛl/
penyberth p e - 'n @ - b e r th /pɛ.'nə.bɛrθ/
penybont p e - 'n @ - b o n t /pɛ.'nə.bɔnt/
penychain p e - 'n @ - x ai n /pɛ.'nə.χaɪn/
penyfai p e - 'n @ - v ai /pɛ.'nə.vaɪ/
penyfed p e - 'n @ - v e d /pɛ.'nə.vɛd/
penygelli p e - n @ - 'g e - lh i /pɛ.nə.'gɛ.ɬɪ/
perego p e - 'r ee - g o /pɛ.'rɛː.gɔ/
perfformiadol p e r - f o r - 'm j aa - d o l /pɛr.fɔr.'mjaː.dɔl/
perigl (foreign) p e - 'r ii - g i l /pɛ.'rɪː.gɪl/
perlesvaus (foreign) p e r - 'l e s - v ay s /pɛr.'lɛs.vaɨs/
peronistiaeth (foreign) p e - r o - 'n i s - t j aay th /pɛ.rɔ.'nɪs.tjɑɨθ/
perrot 'p e - r o t /'pɛ.rɔt/
perseffone p e r - s e - 'f o - n e /pɛr.sɛ.'fɔ.nɛ/
perspectif (foreign) p e r s - 'p e k - t i v /pɛrs.'pɛk.tɪv/
perswad 'p e r s - w a d /'pɛrs.wad/
perón p e - 'r o n /pɛ.'rɔn/
petaen 'p e - t aay n /'pɛ.tɑɨn/
petersburgh p e - 't e r s - p y r g hh /pɛ.'tɛrs.pɨrgh/
petha 'p ee - th a /'pɛː.θa/
pethma 'p e th - m a /'pɛθ.ma/
pgce p ii - jh ii - s ii - 'ii /pɪː.dʒɪː.sɪː.'ɪː/
phendaran f e n - 'd a - r a n /fɛn.'da.ran/
philam 'f i - l a m /'fɪ.lam/
philipps 'f i - l i p s /'fɪ.lɪps/
philti 'f i l - t i /'fɪl.tɪ/
phinees (foreign) f 'ii - n ii z /f'ɪː.nɪːz/
pholisiau f o - 'l i - sh ay /fɔ.'lɪ.ʃaɨ/
phrom 'f r o m /'frɔm/
phrospectws f r o s - 'p e k - t u s /frɔs.'pɛk.tʊs/
pictiwrs (foreign) 'p i k - t iu r s /'pɪk.tɪʊrs/
picton 'p i k - t o n /'pɪk.tɔn/
pilat 'p i - l a t /'pɪ.lat/
pili 'p i - l i /'pɪ.lɪ/
pilkington p i l - 'k i ng - t o n /pɪl.'kɪŋ.tɔn/
pincod 'p i ng - k o d /'pɪŋ.kɔd/
pindar 'p i n - d a r /'pɪn.dar/
piranshahr p i - 'r a n - sh a hh r /pɪ.'ran.ʃahr/
pitar 'p i - t a r /'pɪ.tar/
piwus 'p i - w y s /'pɪ.wɨs/
piz 'p i z /'pɪz/
pku p ii - k ee - 'iu /pɪː.kɛː.'ɪʊ/
plant-yng- 'p l a n - 't y ng /'plan.'tɨŋ/
plasdai 'p l a s - t ai /'plas.taɪ/
plasdy 'p l a s - t y /'plas.tɨ/
plastar (foreign) 'p l a s - t a r /'plas.tar/
plasywernen p l a - s @ - 'w e r - n e n /pla.sə.'wɛr.nɛn/
platanthera (foreign) p l a - t a n - 'th e - r a /pla.tan.'θɛ.ra/
platiaid (foreign) 'p l a t - j ai d /'plat.jaɪd/
pleming 'p l e - m i ng /'plɛ.mɪŋ/
plone p l ou n /pləʊn/
plouvineg p l oy - 'v i - n e g /plɔɨ.'vɪ.nɛg/
plwmbo 'p l u m - b o /'plʊm.bɔ/
plwmpo 'p l u m - p o /'plʊm.pɔ/
plzen 'p l z e n /'plzɛn/
poethach 'p oy - th a x /'pɔɨ.θaχ/
pol (foreign) 'p o l /'pɔl/
polisiau p o - 'l i - sh ay /pɔ.'lɪ.ʃaɨ/
pollinium (foreign) p o - 'lh i - n i - y m /pɔ.'ɬɪ.nɪ.ɨm/
polska (foreign) 'p o l s - k a /'pɔls.ka/
polydore p o - l @ - 'd o - r e /pɔ.lə.'dɔ.rɛ/
polîs (foreign) p o - 'l ii s /pɔ.'lɪːs/
polïs (foreign) 'p o - l i s /'pɔ.lɪs/
pontcysyllte p o n t - k @ - 's @ lh - t e /pɔnt.kə.'səɬ.tɛ/
pontus (foreign) p o n - t y s /pɔn.tɨs/
postcomm 'p oo s t - k o m /'pɔːst.kɔm/
potas (foreign) 'p o - t a s /'pɔ.tas/
potsiars 'p o - ch a r s /'pɔ.tʃars/
powis 'p o - w i s /'pɔ.wɪs/
poynter 'p oy n - t e r /'pɔɨn.tɛr/
ppa 'p aa /'paː/
practisau p r a k - 't ii - s ay /prak.'tɪː.saɨ/
prades (foreign) 'p r aa - d e s /'praː.dɛs/
praffaf 'p r aa - f a v /'praː.fav/
prag 'p r aa g /'praːg/
prebendaidd p r e - 'b e n - d ai dh /prɛ.'bɛn.daɪð/
preece p r e - 'e - k e /prɛ.'ɛ.kɛ/
prichard 'p r ii - x a r d /'prɪː.χard/
pridiannau p r i d - 'j a - n ay /prɪd.'ja.naɨ/
prinnach 'p r i - n a x /'prɪ.naχ/
prinned 'p r i - n e d /'prɪ.nɛd/
priscian 'p r i s - k j a n /'prɪs.kjan/
priscila (foreign) p r 'i - s 'i - l @ /pr'ɪ.s'ɪ.lə/
priveleges (foreign) p r 'i v - l @ - jh @ z /pr'ɪv.lə.dʒəz/
procar (foreign) 'p r o - k a r /'prɔ.kar/
profens 'p r oo - v e n s /'prɔː.vɛns/
proffesor (foreign) p r o - 'f ee - s o r /prɔ.'fɛː.sɔr/
proffit (foreign) 'p r oo - f i t /'prɔː.fɪt/
profforma (foreign) p r o - 'f o r - m a /prɔ.'fɔr.ma/
proffwydonyn (foreign) p r o - f uy - 'd o - n y n /prɔ.fʊɨ.'dɔ.nɨn/
propriator (foreign) p r 'ou - p r ii - 'ei - t @r /pr'əʊ.prɪː.'əɪ.tər/
protestanaidd p r o - t e s - 't a - n ai dh /prɔ.tɛs.'ta.naɪð/
prothero p r o - 'th e - r o /prɔ.'θɛ.rɔ/
prowla (foreign) 'p r ou - l a /'prəʊ.la/
prys-davies p r yy s - 'd ee - v ii z /prɨːs.'dɛː.vɪːz/
prys-jones 'p r @ s - 'jh o - n e s /'prəs.'dʒɔ.nɛs/
pryse 'p r @ - s e /'prə.sɛ/
prytherch 'p r @ - th e r x /'prə.θɛrχ/
prâg 'p r aa g /'praːg/
prês 'p r ee s /'prɛːs/
psb (foreign) p s p /psp/
pughe 'p y g - hh e /'pɨg.hɛ/
pujol 'p uu - j o l /'pʊː.jɔl/
puleston p y - 'l e s - t o n /pɨ.'lɛs.tɔn/
pumwaith (foreign) 'p y m - w ai th /'pɨm.waɪθ/
punjab 'p y n - jh a b /'pɨn.dʒab/
purnell p @@ - 'n e l /pɜː.'nɛl/
pusey 'p yy - s ey /'pɨː.səɨ/
puw-jones 'p yu - 'jh ou n z /'pɨʊ.'dʒəʊnz/
pwal p w a l /pwal/
pwcad (foreign) 'p u - k a d /'pʊ.kad/
pwer p w e r /pwɛr/
pwlfereiddio (foreign) p u l - v e - 'r ei dh - j o /pʊl.vɛ.'rəɪð.jɔ/
pws (foreign) 'p uu s /'pʊːs/
pwyliaid (foreign) 'p uy l - j ai d /'pʊɨl.jaɪd/
pwysicach p uy - 's i - k a x /pʊɨ.'sɪ.kaχ/
pwysicaf p uy - 's i - k a v /pʊɨ.'sɪ.kav/
pwysicaf (foreign) 'p uy - s i - k a v /'pʊɨ.sɪ.kav/
pwysiced p uy - 's i - k e d /pʊɨ.'sɪ.kɛd/
pyrs 'p y r s /'pɨrs/
pythefnosolyn p @ - th e v - n o - 's o - l y n /pə.θɛv.nɔ.'sɔ.lɨn/
pêl- 'p ee l /'pɛːl/
pûr (foreign) p yy r /pɨːr/
pŵel 'p uu - e l /'pʊː.ɛl/
pŵyl 'p uu - y l /'pʊː.ɨl/
q 'k iu /'kɪʊ/
q.v. k j uu - 'v ii /kjʊː.'vɪː/
qbd k iu - b ii - 'd ii /kɪʊ.bɪː.'dɪː/
qu (foreign) 'k yy /'kɨː/
quaboos 'k w aa - b oo s /'kwaː.bɔːs/
quercus (foreign) 'k w e r - k y s /'kwɛr.kɨs/
queste (foreign) 'k w e s - t e /'kwɛs.tɛ/
quetzalcoatl (foreign) k w e t - z a l - k o - 'a - t a l /kwɛt.zal.kɔ.'a.tal/
québec 'k w ee - b e k /'kwɛː.bɛk/
québécois (foreign) 'k w e - 'b e - k oi s /'kwɛ.'bɛ.kɔɪs/
r 'aa r /'aːr/
r (nmcy) 'e r /'ɛr/
r&d aa - r a n d - 'd ii /aː.rand.'dɪː/
r'wbath 'r u - b a th /'rʊ.baθ/
raboul 'r aa - 'b o - y l /'raː.'bɔ.ɨl/
radcliffe r a d - 'k l ii - f e /rad.'klɪː.fɛ/
radeg 'r aa - d e g /'raː.dɛg/
radio-iodin 'r a d - j o - 'j oo - d i n /'rad.jɔ.'jɔː.dɪn/
rageur (foreign) 'r aa - g ey r /'raː.gəɨr/
ragiau (foreign) 'r a g - j ay /'rag.jaɨ/
raliau 'r a l - j ay /'ral.jaɨ/
rallt 'r a lh t /'raɬt/
ramoth 'r a - m o th /'ra.mɔθ/
randerson 'r a n - d @ - s @ n /'ran.də.sən/
rapio 'r a p - j o /'rap.jɔ/
rasus (foreign) 'r aa - s y s /'raː.sɨs/
rata (foreign) 'r a - t a /'ra.ta/
ratcliffe r a t - 'k l ii - f e /rat.'klɪː.fɛ/
raul 'r ay l /'raɨl/
rawlings 'r au - l i ng s /'raʊ.lɪŋs/
raybould r a - '@ - 'b o - y l d /ra.'ə.'bɔ.ɨld/
rbo aa r - b ii - 'oo /aːr.bɪː.'ɔː/
rct a r - s ii - 't ii /ar.sɪː.'tɪː/
readspeaker 'r ii d - s p ii - k @ /'rɪːd.spɪː.kə/
realaidd r e - 'a - l ai dh /rɛ.'a.laɪð/
rechabiaid r e - 'x a b - j ai d /rɛ.'χab.jaɪd/
redknap 'r e d - n a p /'rɛd.nap/
regum (foreign) 'r ee - g y m /'rɛː.gɨm/
rehob (foreign) r i - hh o b /rɪ.hɔb/
reidar (foreign) 'r ei - d a r /'rəɪ.dar/
reslo (foreign) 'r e s - l o /'rɛs.lɔ/
reslwr (foreign) 'r e s - l u r /'rɛs.lʊr/
reslwyr (foreign) 'r e s - l uy r /'rɛs.lʊɨr/
retica (foreign) r e - 't i - k a /rɛ.'tɪ.ka/
rh'wbath 'rh u - b a th /'r̥ʊ.baθ/
rhagddoch rh aa g - dh o x /r̥aːg.ðɔχ/
rhagddon rh aa g - dh o n /r̥aːg.ðɔn/
rhagddot rh aa g - dh o t /r̥aːg.ðɔt/
rhagolygiaeth rh a - g o - 'l @ g - j aay th /r̥a.gɔ.'ləg.jɑɨθ/
rhamantydd rh a - 'm a n - t y dh /r̥a.'man.tɨð/
rhannu'r 'rh a - n y r /'r̥a.nɨr/
rhataf 'rh a - t a v /'r̥a.tav/
rhedag (foreign) 'rh ee - d a g /'r̥ɛː.dag/
rhees rh ii s /r̥ɪːs/
rhen 'rh e n /'r̥ɛn/
rhen (foreign) 'rh e n /'r̥ɛn/
rhesdai 'rh e s - t ai /'r̥ɛs.taɪ/
rhesymolder rh e - s @ - 'm o l - d e r /r̥ɛ.sə.'mɔl.dɛr/
rhibyn 'rh ii - b y n /'r̥ɪː.bɨn/
rhidian 'rh i d - j a n /'r̥ɪd.jan/
rhigyfarch rh i - 'g @ - v a r x /r̥ɪ.'gə.varχ/
rhinoserosys rh i - n o - s e - 'r oo - s y s /r̥ɪ.nɔ.sɛ.'rɔː.sɨs/
rhita 'rh i - t a /'r̥ɪ.ta/
rhithdaith 'rh i th - d ai th /'r̥ɪθ.daɪθ/
rhiwbina rh iu - 'b i - n a /r̥ɪʊ.'bɪ.na/
rhoi'r 'rh oi r /'r̥ɔɪr/
rhoisai 'rh oi - s ai /'r̥ɔɪ.saɪ/
rhoisoch 'rh oi - s o x /'r̥ɔɪ.sɔχ/
rhonwy 'rh o - n uy /'r̥ɔ.nʊɨ/
rhoscefnhir rh o s - 'k e v - n hh i r /r̥ɔs.'kɛv.nhɪr/
rhosddu 'rh o s - dh y /'r̥ɔs.ðɨ/
rhosllanerchrugog rh o s - lh a - n e r - 'x r yy - g o g /r̥ɔs.ɬa.nɛr.'χrɨː.gɔg/
rhosllanerchurgog rh o s - lh a - n e r - 'x y r - g o g /r̥ɔs.ɬa.nɛr.'χɨr.gɔg/
rhoswch 'rh oo - s u x /'r̥ɔː.sʊχ/
rhowlio 'rh ou l - j o /'r̥əʊl.jɔ/
rhowliwch (foreign) 'rh ou - l iu x /'r̥əʊ.lɪʊχ/
rhubannau rh y - 'b a - n ay /r̥ɨ.'ba.naɨ/
rhuf 'rh yy v /'r̥ɨːv/
rhwbath (foreign) 'rh uu - b a th /'r̥ʊː.baθ/
rhwngddi rh u ng - dh i /r̥ʊŋ.ðɪ/
rhwngddo rh u ng - dh o /r̥ʊŋ.ðɔ/
rhwngo rh u - ng o /r̥ʊ.ŋɔ/
rhwngoch rh u - ng o x /r̥ʊ.ŋɔχ/
rhwngot rh u - ng o t /r̥ʊ.ŋɔt/
rhwyddach 'rh uy - dh a x /'r̥ʊɨ.ðaχ/
rhwyddach (foreign) 'rh uy dh a x /'r̥ʊɨðaχ/
rhwyddaf 'rh uy - dh a v /'r̥ʊɨ.ðav/
rhwydrhieni rh uy d - rh i - 'ee - n i /r̥ʊɨd.r̥ɪ.'ɛː.nɪ/
rhwyngon rh uy - ng o n /r̥ʊɨ.ŋɔn/
rhydfudr rh @ d - 'v yy - d y r /r̥əd.'vɨː.dɨr/
rhydgariadog rh @ d - g a r - 'j aa - d o g /r̥əd.gar.'jaː.dɔg/
rhydyddion rh @ - 'd @ dh - j o n /r̥ə.'dəð.jɔn/
rhyfadd (foreign) 'rh @ - v a dh /'r̥ə.vað/
rhyfeddach rh @ - 'v ee - dh a x /r̥ə.'vɛː.ðaχ/
rhyll 'rh y lh /'r̥ɨɬ/
rhyll (foreign) 'rh y lh /'r̥ɨɬ/
rhyngddom 'rh @ ng - dh o m /'r̥əŋ.ðɔm/
rhywiogaethau rh yu - j o - g aay - 'th ay /r̥ɨʊ.jɔ.gɑɨ.'θaɨ/
rickshaw-peiriannol (foreign) 'r i k - sh au - p ei r - 'j a - n o l /'rɪk.ʃaʊ.pəɪr.'ja.nɔl/
ricriwtio r i k - 'r iu t - j o /rɪk.'rɪʊt.jɔ/
riddor 'r i - d o r /'rɪ.dɔr/
rigantona r i - g a n - 't oo - n @ /rɪ.gan.'tɔː.nə/
rimmon (foreign) r 'i - m @ n /r'ɪ.mən/
rioed 'r j oy d /'rjɔɨd/
rioja 'r j o - jh a /'rjɔ.dʒa/
riou 'r j oy /'rjɔɨ/
riportio (foreign) r i - 'p o r - t j o /rɪ.'pɔr.tjɔ/
rje aa r - jh ee - 'ii /aːr.dʒɛː.'ɪː/
rnib aa - r e - n ai - 'b ii /aː.rɛ.naɪ.'bɪː/
roald 'r oo - @ l d /'rɔː.əld/
robaits 'r oo - b ai t s /'rɔː.baɪts/
robaitsh 'r oo - b ai ch /'rɔː.baɪtʃ/
roce aa - r oo - s ii - 'ii /aː.rɔː.sɪː.'ɪː/
roci (foreign) 'r o - k i /'rɔ.kɪ/
roddick 'r o - d i k /'rɔ.dɪk/
roeddan 'r oy - dh a n /'rɔɨ.ðan/
roeddan (foreign) 'r oy - dh a n /'rɔɨ.ðan/
rogerson r o - 'g e r - s o n /rɔ.'gɛr.sɔn/
roi'r 'r oi r /'rɔɪr/
romaine r o - 'm ai - n e /rɔ.'maɪ.nɛ/
romaneg r o - 'm a - n e g /rɔ.'ma.nɛg/
romau 'r o - m ay /'rɔ.maɨ/
rondol 'r o n - d o l /'rɔn.dɔl/
rosada r o - 's aa - d a /rɔ.'saː.da/
rosea (foreign) r o - 's e - a /rɔ.'sɛ.a/
rosfa 'r o s - v a /'rɔs.va/
roska 'r o s - k a /'rɔs.ka/
rosser 'r o - s e r /'rɔ.sɛr/
rostock 'r o s - t o k /'rɔs.tɔk/
rowlo (foreign) 'r ou - l o /'rəʊ.lɔ/
rowls (foreign) 'r ou l s /'rəʊls/
rowlwr (foreign) 'r ou - l u r /'rəʊ.lʊr/
rowndie 'r ou n - d j e /'rəʊn.djɛ/
rowndio (foreign) 'r ou n - d j o /'rəʊn.djɔ/
roydsdale 'r oi d - z d ee l /'rɔɪd.zdɛːl/
rq aa r - 'k iu /aːr.'kɪʊ/
rrc (foreign) r k /rk/
rubenstein r y - 'b e n s - t ei n /rɨ.'bɛns.təɪn/
ruhamah r y - 'hh a - m a hh /rɨ.'ha.mah/
rupies (foreign) 'r y p - j e s /'rɨp.jɛs/
ruy r y - y /rɨ.ɨ/
rw 'r uu /'rʊː/
rw (foreign) 'r uu /'rʊː/
rwbath 'r uu - b a th /'rʊː.baθ/
rwbath (foreign) 'r uu - b a th /'rʊː.baθ/
rwi (foreign) r w i /rwɪ/
rwla (foreign) 'r u - l a /'rʊ.la/
rwmaneg r u - 'm a - n e g /rʊ.'ma.nɛg/
rwmaniaid (foreign) r u - 'm a n - j ai d /rʊ.'man.jaɪd/
rwng 'r u ng /'rʊŋ/
rwseg 'r uu - s e g /'rʊː.sɛg/
rwsnos 'r u s - n o s /'rʊs.nɔs/
rwsnos (foreign) 'r u s - n o s /'rʊs.nɔs/
rwy'n 'r uy n /'rʊɨn/
rwyn 'r uy n /'rʊɨn/
rwyn (foreign) r uy n /rʊɨn/
ryden 'r @ - d e n /'rə.dɛn/
ryden (foreign) 'r @ - d e n /'rə.dɛn/
rydwi 'r @ d - w i /'rəd.wɪ/
ryn 'r y n /'rɨn/
rynek (foreign) 'r @ - n e k /'rə.nɛk/
rŵm (foreign) 'r uu m /'rʊːm/
rŷch 'r yy x /'rɨːχ/
rẅwan 'r u - u - a n /'rʊ.ʊ.an/
rẅwan (foreign) 'r u - u - a n /'rʊ.ʊ.an/
s 'e s /'ɛs/
s'dim 's t i m /'stɪm/
s'mae 's m aay /'smɑɨ/
s-chanf 's x a n v /'sχanv/
sacerdos (foreign) s a - 'k e r - d o s /sa.'kɛr.dɔs/
sacre 's ei - k r @ /'səɪ.krə/
sacsoni s a k - 's o - n i /sak.'sɔ.nɪ/
sadhu 's a d - hh y /'sad.hɨ/
sadique s a - 'd i - k e /sa.'dɪ.kɛ/
sadwceaid s a - d u - 'k e - ai d /sa.dʊ.'kɛ.aɪd/
saernio 's aay r - n j o /'sɑɨr.njɔ/
saffach 's aa - f a x /'saː.faχ/
saffari (foreign) s a - 'f a - r i /sa.'fa.rɪ/
sai 's ai /'saɪ/
sai (foreign) 's ai /'saɪ/
sajudis s a - 'jh yy - d i s /sa.'dʒɨː.dɪs/
salaf 's a - l a v /'sa.lav/
salesbury s a - l e s - 'p y - r y /sa.lɛs.'pɨ.rɨ/
salim 's a - l i m /'sa.lɪm/
salonica s a - l o - 'n i - k a /sa.lɔ.'nɪ.ka/
salwn (foreign) 's a - l u n /'sa.lʊn/
samariad s a - 'm a r - j a d /sa.'mar.jad/
samhain 's a m hh ai n /'samhaɪn/
samma (foreign) s 'a - m @ /s'a.mə/
samon (foreign) 's a - m o n /'sa.mɔn/
samrin 's a m - r i n /'sam.rɪn/
samua (foreign) s a - 'm y - a /sa.'mɨ.a/
sancteiddiach s a ng k - 't ei dh - j a x /saŋk.'təɪð.jaχ/
sancteiddiolaf s a ng k - t ei dh - 'j o - l a v /saŋk.təɪð.'jɔ.lav/
sans-seriff (foreign) 's a n s - 's e - r i f /'sans.'sɛ.rɪf/
sanscrit (foreign) 's a n s - k r i t /'sans.krɪt/
sar 's a r /'sar/
sarjant (foreign) 's a r - jh a n t /'sar.dʒant/
sarjiant (foreign) 's a r jh - j a n t /'sardʒ.jant/
sarnicol s a r - 'n i - k o l /sar.'nɪ.kɔl/
sarra 's a - r a /'sa.ra/
saupm 's au - p @ m /'saʊ.pəm/
saussure s ay - 's y - r e /saɨ.'sɨ.rɛ/
sawdi 's au - d i /'saʊ.dɪ/
saxifraga (foreign) s a k s i v - 'r aa - g a /saksɪv.'raː.ga/
sbarcio 's p a r - k j o /'spar.kjɔ/
sbec (foreign) 's p e k /'spɛk/
sbector (foreign) 's p e k - t o r /'spɛk.tɔr/
sbesial 's p e - sh a l /'spɛ.ʃal/
sbesial (foreign) 's p e - sh a l /'spɛ.ʃal/
sbienddrych 's p j e n - dh r y x /'spjɛn.ðrɨχ/
sbiwch (foreign) 's p iu x /'spɪʊχ/
sblashio (foreign) 's p l a sh - j o /'splaʃ.jɔ/
sbloet (foreign) 's p l oy t /'splɔɨt/
sborion 's p o r - j o n /'spɔr.jɔn/
sbïwr 's p i - u r /'spɪ.ʊr/
sbïwyr 's p i - uy r /'spɪ.ʊɨr/
scambler 's k a m - b l e r /'skam.blɛr/
schleiermacher s x l e - j e r - 'm aa - x e r /sχlɛ.jɛr.'maː.χɛr/
schon (foreign) 's x o n /'sχɔn/
scrabl (foreign) 's k r aa - b a l /'skraː.bal/
scuol 's k y - o l /'skɨ.ɔl/
scya e - s e - k @@ - 'aa /ɛ.sɛ.kɜː.'aː/
sdim 's t i m /'stɪm/
sdp e s - d ii - 'p ii /ɛs.dɪː.'pɪː/
sdsl e s - d ii - e - 's e l /ɛs.dɪː.ɛ.'sɛl/
sealink (foreign) s e - 'a - l i n k /sɛ.'a.lɪnk/
sebedeus s e - 'b ee - d ey s /sɛ.'bɛː.dəɨs/
seciwriti (foreign) s e - k iu - 'r i - t i /sɛ.kɪʊ.'rɪ.tɪ/
seffti (foreign) 's e f - t i /'sɛf.tɪ/
sefydliedig s e - v @ d - 'l j ee - d i g /sɛ.vəd.'ljɛː.dɪg/
segontiwm s e - 'g o n - t iu m /sɛ.'gɔn.tɪʊm/
segrwyd 's e g - r uy d /'sɛg.rʊɨd/
sei (foreign) 's ei /'səɪ/
seiber-gwis 's ei - 'b e r - 'g w ii s /'səɪ.'bɛr.'gwɪːs/
seici (foreign) 's ei - k i /'səɪ.kɪ/
seicic 's ei - k i k /'səɪ.kɪk/
seimyn (foreign) 's ei - m y n /'səɪ.mɨn/
seint (foreign) 's ei n t /'səɪnt/
seiont 's e - j o n t /'sɛ.jɔnt/
seisnigedig s ei s - n i - 'g ee - d i g /səɪs.nɪ.'gɛː.dɪg/
seithugrwydd s ei - 'th y g - r uy dh /səɪ.'θɨg.rʊɨð/
sel 's e l /'sɛl/
selewcia (foreign) 's e - l eu sh @ /'sɛ.lɛʊʃə/
selotiaeth s e - 'l o t - j aay th /sɛ.'lɔt.jɑɨθ/
selway 's e l - w a - y /'sɛl.wa.ɨ/
sempringham s e m - 'p r i ng hh a m /sɛm.'prɪŋham/
sendina s e n - 'd i - n a /sɛn.'dɪ.na/
senena s e - 'n e - n a /sɛ.'nɛ.na/
senglen 's e ng - l e n /'sɛŋ.lɛn/
senorita (foreign) s e - n o - 'r i - t a /sɛ.nɔ.'rɪ.ta/
sens (foreign) 's e n s /'sɛns/
sensws 's e n - s u s /'sɛn.sʊs/
sentimentaliti (foreign) s e n - t i - m e n - t a - 'l i - t i /sɛn.tɪ.mɛn.ta.'lɪ.tɪ/
senwsi (foreign) s e - 'n uu - s i /sɛ.'nʊː.sɪ/
ser 's e r /'sɛr/
serfia (foreign) 's e r - v j a /'sɛr.vja/
seror (foreign) 's e - r o r /'sɛ.rɔr/
seros 's e - r o s /'sɛ.rɔs/
serosadam s e - r o - 's aa - d a m /sɛ.rɔ.'saː.dam/
serosas (foreign) s e - 'r oo - s a s /sɛ.'rɔː.sas/
serosiaid s e - 'r o - sh ai d /sɛ.'rɔ.ʃaɪd/
serps 's @@ p s /'sɜːps/
setiwr 's e - t iu r /'sɛ.tɪʊr/
setiwrs (foreign) 's e - t iu r s /'sɛ.tɪʊrs/
seymor 's ey - m o r /'səɨ.mɔr/
sffer 's f e r /'sfɛr/
sfx e - s e - 'f e k s /ɛ.sɛ.'fɛks/
sg e s - 'jh ii /ɛs.'dʒɪː/
sgarlad 's k a r - l a d /'skar.lad/
sgarmesi s k a r - 'm ee - s i /skar.'mɛː.sɪ/
sgcp e - s e - g e k - 'p ii /ɛ.sɛ.gɛk.'pɪː/
sgen 's k e n /'skɛn/
sgen (foreign) 's k e n /'skɛn/
sgiais 's k j ai s /'skjaɪs/
sgiliaith 's k i l - j ai th /'skɪl.jaɪθ/
sgin 's k i n /'skɪn/
sgio 's k j oo /'skjɔː/
sgipiau 's k i p - j ay /'skɪp.jaɨ/
sgis (foreign) 's k ii s /'skɪːs/
sglyfath 's k l @ - v a th /'sklə.vaθ/
sgrifenwyr s k r i - 'v e - n uy r /skrɪ.'vɛ.nʊɨr/
sgrîn 's k r ii n /'skrɪːn/
sgubell (foreign) 's k yy - b e lh /'skɨː.bɛɬ/
sgubodd 's k yy - b o dh /'skɨː.bɔð/
sgut 's k y t /'skɨt/
sgut (foreign) 's k y t /'skɨt/
sgweiar (foreign) 's k w e - j a r /'skwɛ.jar/
sgweiriaid 's k w ei r - j ai d /'skwəɪr.jaɪd/
sgwier 's k u - 'j e r /'skʊ.'jɛr/
sgwn 's k u n /'skʊn/
sgwnerau (foreign) s k u - 'n e - r ay /skʊ.'nɛ.raɨ/
sgyrsiol 's k @ r - sh o l /'skər.ʃɔl/
sgîl 's k ii l /'skɪːl/
sgîl (foreign) 's k ii l /'skɪːl/
sgŵl (foreign) 's k uu l /'skʊːl/
shadrach 'sh a d - r a x /'ʃad.raχ/
shafins (foreign) 'sh aa - v i n s /'ʃaː.vɪns/
shamshuipo (foreign) sh a m - sh y - 'i - p o /ʃam.ʃɨ.'ɪ.pɔ/
shankland 'sh a n - k l a n d /'ʃan.kland/
shechiaid 'sh e x - j ai d /'ʃɛχ.jaɪd/
sheil 'sh ei l /'ʃəɪl/
sheol (foreign) sh e - o l /ʃɛ.ɔl/
shiap 'sh j a p /'ʃjap/
shockwave 'sh o k - w ee v /'ʃɔk.wɛːv/
shoni 'sh o - n i /'ʃɔ.nɪ/
shopmobility sh o p - m o - 'b i - l i - t i /ʃɔp.mɔ.'bɪ.lɪ.tɪ/
shreeves sh r e - 'e - v e s /ʃrɛ.'ɛ.vɛs/
shute 'sh y - t e /'ʃɨ.tɛ/
shw e - s ee ch - 'd @ - b @ - l iu /ɛ.sɛːtʃ.'də.bə.lɪʊ/
shwd (foreign) 'sh uu d /'ʃʊːd/
shwsbri (foreign) 'sh u s - p r i /'ʃʊs.prɪ/
shêr (foreign) 'sh ee r /'ʃɛːr/
sia (foreign) 'sh aa /'ʃaː/
siad (foreign) 'sh aa d /'ʃaːd/
sialensau sh a - 'l e n - s ay /ʃa.'lɛn.saɨ/
siampên (foreign) sh a m - 'p ee n /ʃam.'pɛːn/
sian 'sh a n /'ʃan/
siap (foreign) 'sh a p /'ʃap/
siapaneaid (foreign) sh a - p a - 'n e - ai d /ʃa.pa.'nɛ.aɪd/
siapaneaidd sh a - p a - 'n e - ai dh /ʃa.pa.'nɛ.aɪð/
sicrach 's i k - r a x /'sɪk.raχ/
sicred 's i k - r e d /'sɪk.rɛd/
sidley 's i d - l ey /'sɪd.ləɨ/
siecle (foreign) 'sh e k - l e /'ʃɛk.lɛ/
siecoslofacia sh e - k o s - l o - 'v a k - j a /ʃɛ.kɔs.lɔ.'vak.ja/
siem 'sh e m /'ʃɛm/
sifalrïaidd s i - v a l - 'r i - ai dh /sɪ.val.'rɪ.aɪð/
siffilis s i - 'f i - l i s /sɪ.'fɪ.lɪs/
sigaret s i - 'g a - r e t /sɪ.'ga.rɛt/
sigarets (foreign) s i - 'g a - r e t s /sɪ.'ga.rɛts/
silc 's i l k /'sɪlk/
siliwm 's i - l iu m /'sɪ.lɪʊm/
siloam s i - 'l o - a m /sɪ.'lɔ.am/
silvaplana s i l - v a p - 'l a - n a /sɪl.vap.'la.na/
simei (foreign) s 'i m - ei /s'ɪm.əɪ/
simffoni (foreign) s i m - 'f o - n i /sɪm.'fɔ.nɪ/
simmonds 's i - m o n d s /'sɪ.mɔnds/
sinderela (foreign) s i n - d e - 'r e - l a /sɪn.dɛ.'rɛ.la/
sindicet (foreign) s i n - 'd i - k e t /sɪn.'dɪ.kɛt/
sineaidd s i - 'n e - ai dh /sɪ.'nɛ.aɪð/
sinemau s i - 'n e - m ay /sɪ.'nɛ.maɨ/
singh 's i ng hh /'sɪŋh/
singl (foreign) 's i - ng i l /'sɪ.ŋɪl/
sinn (foreign) 's i n /'sɪn/
siol 'sh o l /'ʃɔl/
sion 'sh o n /'ʃɔn/
siope 'sh o - p e /'ʃɔ.pɛ/
siopio (foreign) 'sh o p - j o /'ʃɔp.jɔ/
sior 'sh o r /'ʃɔr/
sirgar 's i r - g a r /'sɪr.gar/
sisili s i - 's i - l i /sɪ.'sɪ.lɪ/
sistem 's i s - t e m /'sɪs.tɛm/
sistrymau (foreign) s i s - 't r @ - m ay /sɪs.'trə.maɨ/
siwgwr 's iu - g u r /'sɪʊ.gʊr/
siwrin 's iu - r i n /'sɪʊ.rɪn/
siwrin (foreign) 's iu - r i n /'sɪʊ.rɪn/
siwsi 's iu - s i /'sɪʊ.sɪ/
skillset (foreign) 's k i lh - s e t /'skɪɬ.sɛt/
slasan (foreign) 's l aa - s a n /'slaː.san/
slawer 's l a - w e r /'sla.wɛr/
sleim (foreign) 's l ei m /'sləɪm/
slipars (foreign) 's l i - p a r s /'slɪ.pars/
slipers (foreign) 's l i - p e r s /'slɪ.pɛrs/
slipo 's l i - p o /'slɪ.pɔ/
slwsh (foreign) 's l u sh /'slʊʃ/
smwtyn (foreign) 's m u - t y n /'smʊ.tɨn/
smôc (foreign) 's m oo k /'smɔːk/
snowdonia s n oo - 'd oo n - j @ /snɔː.'dɔːn.jə/
snowt 's n ou t /'snəʊt/
snyff 's n yy f /'snɨːf/
soba (foreign) s 'ou - b @ /s'əʊ.bə/
sobab (foreign) s 'ou - b @ b /s'əʊ.bəb/
socer (foreign) 's o - k e r /'sɔ.kɛr/
soch 's oo x /'sɔːχ/
soch (foreign) 's oo x /'sɔːχ/
soffia 's o f - j a /'sɔf.ja/
sofietiaid s o v - 'j e t - j ai d /sɔv.'jɛt.jaɪd/
soldiwr (foreign) 's o l - d iu r /'sɔl.dɪʊr/
solingen s o - 'l i - ng e n /sɔ.'lɪ.ŋɛn/
somaliaid s o - 'm a l - j ai d /sɔ.'mal.jaɪd/
somers 's oo - m @ z /'sɔː.məz/
sorrento s o - 'r e n - t o /sɔ.'rɛn.tɔ/
sosio-ieithyddiaeth 's o - sh o - j ei - 'th @ dh - j aay th /'sɔ.ʃɔ.jəɪ.'θəð.jɑɨθ/
southerndown s oy - 'th e r n - d ou n /sɔɨ.'θɛrn.dəʊn/
sowldiwr (foreign) 's ou l - d iu r /'səʊl.dɪʊr/
sowth (foreign) 's ou th /'səʊθ/
sp e s - 'p ii /ɛs.'pɪː/
spaem e s - p ii - aa - ee - 'e m /ɛs.pɪː.aː.ɛː.'ɛm/
spd (foreign) s p d /spd/
spectols (foreign) 's p e k - t o l s /'spɛk.tɔls/
spectrwm (foreign) 's p e k - t r u m /'spɛk.trʊm/
ssccrh e - s e - s e - k e k - 'rh ii /ɛ.sɛ.sɛ.kɛk.'r̥ɪː/
stabal 's t aa - b a l /'staː.bal/
stabal (foreign) 's t aa - b a l /'staː.bal/
stachowski s t a - 'x ou s - k i /sta.'χəʊs.kɪ/
stadudol s t a - 'd yy - d o l /sta.'dɨː.dɔl/
stanleys (foreign) 's t a n - l ey s /'stan.ləɨs/
stansty 's t a n s - t y /'stans.tɨ/
stebonheath s t e - 'b o n hh e - a th /stɛ.'bɔnhɛ.aθ/
stelcian 's t e l - k j a n /'stɛl.kjan/
stena (foreign) 's t e - n a /'stɛ.na/
stepan (foreign) 's t e - p a n /'stɛ.pan/
sterics (foreign) 's t e - r i k s /'stɛ.rɪks/
sternwood 's t e r n - w oo d /'stɛrn.wɔːd/
sterry 's t e - r y /'stɛ.rɨ/
stiches 's t i - ch i z /'stɪ.tʃɪz/
stiniog 's t i n - j o g /'stɪn.jɔg/
stiwart 's t i - w a r t /'stɪ.wart/
stiwdant (foreign) 's t iu - d a n t /'stɪʊ.dant/
stiwdios (foreign) 's t iu d - j o s /'stɪʊd.jɔs/
stiwt 's t iu t /'stɪʊt/
stor 's t o r /'stɔr/
storiau 's t o r - j ay /'stɔr.jaɨ/
storiol 's t o r - j o l /'stɔr.jɔl/
storws 's t o - r u s /'stɔ.rʊs/
stp e s - t ii - 'p ii /ɛs.tɪː.'pɪː/
strae 's t r aay /'strɑɨ/
stryt 's t r y t /'strɨt/
strytwise (foreign) s t r @ t - 'w ii - s e /strət.'wɪː.sɛ/
stu 's t iu /'stɪʊ/
stumia 's t y m - j a /'stɨm.ja/
sturge 's t y r - g e /'stɨr.gɛ/
stwna 's t u - n a /'stʊ.na/
stwna (foreign) 's t u - n a /'stʊ.na/
stydio 's t @ d - j o /'stəd.jɔ/
styfnig 's t @ v - n i g /'stəv.nɪg/
styfnigrwydd s t @ v - 'n i g - r uy dh /stəv.'nɪg.rʊɨð/
styllod 's t @ - lh o d /'stə.ɬɔd/
styrbio (foreign) 's t @ r - b j o /'stər.bjɔ/
stâd 's t aa d /'staːd/
stîd (foreign) 's t ii d /'stɪːd/
suff (foreign) s '@ f /s'əf/
suful 's yy - v y l /'sɨː.vɨl/
sugden 's y g - d e n /'sɨg.dɛn/
sugnion 's y g - n j o n /'sɨg.njɔn/
sukiennice s y k - j e - 'n i - k e /sɨk.jɛ.'nɪ.kɛ/
sulwen 's y l - w e n /'sɨl.wɛn/
sumbol (foreign) 's y m - b o l /'sɨm.bɔl/
sundar 's y n - d a r /'sɨn.dar/
susauna s y - 's ay - n a /sɨ.'saɨ.na/
swatiai 's w a t - j ai /'swat.jaɪ/
swire 's w ai r /'swaɪr/
swisdir 's w i s - t i r /'swɪs.tɪr/
swits (foreign) s w i t s /swɪts/
switsiwch 's w i - ch iu x /'swɪ.tʃɪʊχ/
swn 's u n /'sʊn/
swpar (foreign) 's u - p a r /'sʊ.par/
sybsideiddio (foreign) s @ b - s i - 'd ei dh - j o /səb.sɪ.'dəɪð.jɔ/
sydna 's @ d - n a /'səd.na/
syfwr 's @ - v u r /'sə.vʊr/
syfydrin (foreign) s @ - 'v @ d - r i n /sə.'vəd.rɪn/
sylhet 's @ l - hh e t /'səl.hɛt/
symboliaeth s @ m - 'b o l - j aay th /səm.'bɔl.jɑɨθ/
symlach 's @ m - l a x /'səm.laχ/
symmons 's @ - m o n s /'sə.mɔns/
symons 's @ - m o n s /'sə.mɔns/
syncronig s @ ng - 'k r o - n i g /səŋ.'krɔ.nɪg/
syntagmatig s @ n - t a g - 'm a - t i g /sən.tag.'ma.tɪg/
syrcit (foreign) 's @ r - k i t /'sər.kɪt/
syrffwyr 's @ r - f uy r /'sər.fʊɨr/
syrfio 's @ r - v j o /'sər.vjɔ/
sywth 's yu th /'sɨʊθ/
sâff 's aa f /'saːf/
sâff (foreign) 's aa f /'saːf/
sâr 's aa r /'saːr/
sîn 's ii n /'sɪːn/
sôs (foreign) 's oo s /'sɔːs/
t 't ii /'tɪː/
taac 't aa k /'taːk/
tach 't a x /'taχ/
tacsis 't a k - s i s /'tak.sɪs/
tadcu 't a d - k y /'tad.kɨ/
tae 't aay /'tɑɨ/
tae (foreign) 't aay /'tɑɨ/
taj 't a jh /'tadʒ/
talarn 't a - l a r n /'ta.larn/
taleithau t a - l ei - 'th ay /ta.ləɪ.'θaɨ/
talf 't a l v /'talv/
talfryn 't a l - v r @ n /'tal.vrən/
tallarn 't a - lh a r n /'ta.ɬarn/
tamprwydd 't a m - p r uy dh /'tam.prʊɨð/
tanddatblygiad t a n - dh a t - 'b l @ g - j a d /tan.ðat.'bləg.jad/
tanrallt 't a n - r a lh t /'tan.raɬt/
tanyfron t a - 'n @ v - r o n /ta.'nəv.rɔn/
tarawiadol t a - r au - 'j aa - d o l /ta.raʊ.'jaː.dɔl/
tarawiadol (foreign) t a - r au - 'j aa - d o l /ta.raʊ.'jaː.dɔl/
tarawodd t a - 'r a - w o dh /ta.'ra.wɔð/
tasat 't aa - s a t /'taː.sat/
tasat (foreign) 't aa - s a t /'taː.sat/
tasau 't aa - s ay /'taː.saɨ/
tasker 't a s - k e r /'tas.kɛr/
tatra 't a t - r a /'tat.ra/
tca t ii - e - 'k aa /tɪː.ɛ.'kaː/
td t d /td/
tdc t ii - d ii - 'e k /tɪː.dɪː.'ɛk/
tebbitt 't e - b i t /'tɛ.bɪt/
tebycach t e - 'b @ - k a x /tɛ.'bə.kaχ/
tebycaf t e - 'b @ - k a v /tɛ.'bə.kav/
tecel (foreign) 't e - k e l /'tɛ.kɛl/
tecell 't e - k e lh /'tɛ.kɛɬ/
tecstiliau t e k - 's t i l - j ay /tɛk.'stɪl.jaɨ/
tecstio 't e k s - t j o /'tɛks.tjɔ/
tedworth (foreign) t e d - w '@r th /tɛd.w'ərθ/
tegane t e - 'g a - n e /tɛ.'ga.nɛ/
tegane (foreign) t e - 'g a - n e /tɛ.'ga.nɛ/
tegannedd t e - 'g a - n e dh /tɛ.'ga.nɛð/
tegeiriannau t e - g ei r - 'j a - n ay /tɛ.gəɪr.'ja.naɨ/
teiars (foreign) 't e - j a r s /'tɛ.jars/
teidi 't ei - d i /'təɪ.dɪ/
teidi (foreign) 't ei - d i /'təɪ.dɪ/
teiliau 't ei l - j ay /'təɪl.jaɨ/
teimlo'n 't ei m - l o n /'təɪm.lɔn/
teirawr 't ei - r au r /'təɪ.raʊr/
teirawr (foreign) 't ei - r au r /'təɪ.raʊr/
teirieithog t ei r - 'j ei - th o g /təɪr.'jəɪ.θɔg/
teirieithrwydd t ei r - 'j ei th - r uy dh /təɪr.'jəɪθ.rʊɨð/
teisan 't ei - s a n /'təɪ.san/
telifision (foreign) t e - l i - 'v i - sh o n /tɛ.lɪ.'vɪ.ʃɔn/
teligram (foreign) t e - 'l i g - r a m /tɛ.'lɪg.ram/
tenancious (foreign) t 'e - n 'a n - sh @ s /t'ɛ.n'an.ʃəs/
tenovus 't e - n @ - v @ s /'tɛ.nə.vəs/
teregid t e - 'r ee - g i d /tɛ.'rɛː.gɪd/
terentius t e - 'r e n - t i - y s /tɛ.'rɛn.tɪ.ɨs/
termcymru t e r - m - 'k @ m - r y /tɛr.m.'kəm.rɨ/
terminolegol t e r - m i - n o - 'l ee - g o l /tɛr.mɪ.nɔ.'lɛː.gɔl/
tewach 't e - w a x /'tɛ.waχ/
tgch t g x /tgχ/
tgs t ii - e - 'g e s /tɪː.ɛ.'gɛs/
thadcu 'th a d - k y /'θad.kɨ/
thalia 'th a l - j a /'θal.ja/
thanciw (foreign) 'th a ng - k iu /'θaŋ.kɪʊ/
thatcheriaeth (foreign) th a t - 'x e r - j aay th /θat.'χɛr.jɑɨθ/
theirieithrwydd th ei r - 'j ei th - r uy dh /θəɪr.'jəɪθ.rʊɨð/
themau (foreign) 'th e - m ay /'θɛ.maɨ/
theomemphus th e - o - 'm e m - f y s /θɛ.ɔ.'mɛm.fɨs/
theosis (foreign) th e - 'oo - s i s /θɛ.'ɔː.sɪs/
theros 'th e - r o s /'θɛ.rɔs/
therosina th e - r o - 's i - n a /θɛ.rɔ.'sɪ.na/
theudas (foreign) 'th ey - d a s /'θəɨ.das/
thirlwall 'th i r l - w a lh /'θɪrl.waɬ/
thomin 'th o - m i n /'θɔ.mɪn/
thorburn 'th o r - b y r n /'θɔr.bɨrn/
throckmorton th r o k - 'm o r - t o n /θrɔk.'mɔr.tɔn/
thrychfilod th r @ x - 'v i - l o d /θrəχ.'vɪ.lɔd/
thylluanod th @ - lh y - 'a - n o d /θə.ɬɨ.'a.nɔd/
thyroidedd (foreign) th @ - 'r oi - d e dh /θə.'rɔɪ.dɛð/
ti'n 't ai n /'taɪn/
tillett 't i - lh e t /'tɪ.ɬɛt/
tillich 't i - lh i x /'tɪ.ɬɪχ/
tilsli 't i l s - l i /'tɪls.lɪ/
tilston (foreign) t 'i l - s t @ n /t'ɪl.stən/
tinwen 't i n - w e n /'tɪn.wɛn/
tirfeddiannol (foreign) t i r - v e dh - 'j a - n o l /tɪr.vɛð.'ja.nɔl/
tirweddol t i r - 'w ee - dh o l /tɪr.'wɛː.ðɔl/
tiwnadwy t iu - 'n aa - d uy /tɪʊ.'naː.dʊɨ/
tlotach 't l o - t a x /'tlɔ.taχ/
tlotaf 't l o - t a v /'tlɔ.tav/
tlysaf 't l @ - s a v /'tlə.sav/
tn (foreign) t n /tn/
tocyneiddio t o k - @ n - 'ei dh - j o /tɔk.ən.'əɪð.jɔ/
toddiannau t o dh - 'j a - n ay /tɔð.'ja.naɨ/
toedd 't oy dh /'tɔɨð/
toman (foreign) 't o - m a n /'tɔ.man/
tomatos (foreign) t o - 'm a - t o s /tɔ.'ma.tɔs/
tomenni t o - 'm e - n i /tɔ.'mɛ.nɪ/
tonle 't o n - l e /'tɔn.lɛ/
tonsilectomiau (foreign) t o n - s i - l e k - 't o m - j ay /tɔn.sɪ.lɛk.'tɔm.jaɨ/
topsham 't o p - sh a m /'tɔp.ʃam/
toriaid (foreign) 't o r - j ai d /'tɔr.jaɪd/
toriaidd 't o r - j ai dh /'tɔr.jaɪð/
totalitariaeth t o - t a - l i - 't a r - j aay th /tɔ.ta.lɪ.'tar.jɑɨθ/
towlu (foreign) 't ou - l y /'təʊ.lɨ/
towson 't ou - s o n /'təʊ.sɔn/
toxicodendron (foreign) t o k s i - k o - 'd e n - d r o n /tɔksɪ.kɔ.'dɛn.drɔn/
tr t r /tr/
tractariaid t r a k - 't a r - j ai d /trak.'tar.jaɪd/
trados 't r aa - d o s /'traː.dɔs/
traenio 't r aay n - j o /'trɑɨn.jɔ/
traffont 't r aa - f o n t /'traː.fɔnt/
trampolinio t r a m - p o - 'l i n - j o /tram.pɔ.'lɪn.jɔ/
traveline 't r a - v @ - l ai n /'tra.və.laɪn/
trawsdoriad t r au s - 't o r - j a d /traʊs.'tɔr.jad/
trebern (foreign) 't r ee - b e r n /'trɛː.bɛrn/
trebor 't r ee - b o r /'trɛː.bɔr/
trefeiddyn t r e - 'v ei - dh y n /trɛ.'vəɪ.ðɨn/
trefigin t r e - 'v ii - g i n /trɛ.'vɪː.gɪn/
treforest t r e - 'v o - r e s t /trɛ.'vɔ.rɛst/
tregelles t r e - 'g e - lh e s /trɛ.'gɛ.ɬɛs/
treharne t r e - 'hh a r - n e /trɛ.'har.nɛ/
tremenheere t r e - m e n hh e - 'e - r e /trɛ.mɛnhɛ.'ɛ.rɛ/
tren 't r e n /'trɛn/
trewais 't r e - w ai s /'trɛ.waɪs/
trewir 't r e - w i r /'trɛ.wɪr/
treysgawen 't r ey s - 'k a - w e n /'trəɨs.'ka.wɛn/
tri- 't r ii /'trɪː/
tria (foreign) 't r j aa /'trjaː/
triair 't r ii /'trɪː/
trillwyn 't r i - lh uy n /'trɪ.ɬʊɨn/
tristach 't r i s - t a x /'trɪs.taχ/
triwch (foreign) 't r iu x /'trɪʊχ/
troai 't r o - ai /'trɔ.aɪ/
troedigaeth t r oy - 'd ii - g aay th /trɔɨ.'dɪː.gɑɨθ/
troisom 't r oi - s o m /'trɔɪ.sɔm/
tropyn (foreign) 't r o - p y n /'trɔ.pɨn/
trostoch t r o s - t o x /trɔs.tɔχ/
troston t r o s - t o n /trɔs.tɔn/
trostot t r o s - t o t /trɔs.tɔt/
trwbadwraidd t r u - b a - 'd u - r ai dh /trʊ.ba.'dʊ.raɪð/
trwsgwl 't r u s - k u l /'trʊs.kʊl/
trwshio (foreign) 't r u sh - j o /'trʊʃ.jɔ/
trwy'r 't r uy r /'trʊɨr/
trwyddoch t r uy - dh o x /trʊɨ.ðɔχ/
trwyddon t r uy - dh o n /trʊɨ.ðɔn/
trwyddot t r uy - dh o t /trʊɨ.ðɔt/
trychfilod t r @ x - 'v i - l o d /trəχ.'vɪ.lɔd/
trymach 't r @ - m a x /'trə.maχ/
trymaf 't r @ - m a v /'trə.mav/
trymed 't r @ - m e d /'trə.mɛd/
trywyddau t r @ - 'w @ - dh ay /trə.'wə.ðaɨ/
trá 't r aa /'traː/
trôdd 't r oo dh /'trɔːð/
tsb (foreign) t s p /tsp/
tsecoslofacia ch e - k o s - l o - 'v a k - j a /tʃɛ.kɔs.lɔ.'vak.ja/
tseina 'ch ei - n a /'tʃəɪ.na/
tseineaid (foreign) ch ei - 'n e - ai d /tʃəɪ.'nɛ.aɪd/
tsiecaidd 'ch e - k ai dh /'tʃɛ.kaɪð/
tsieciaid (foreign) 'ch e k - j ai d /'tʃɛk.jaɪd/
tts t ii - t ii - 'e s /tɪː.tɪː.'ɛs/
tueddau t y - 'ee - dh ay /tɨ.'ɛː.ðaɨ/
tunnicliffe t y - n i k - 'l ii - f e /tɨ.nɪk.'lɪː.fɛ/
tw 't uu /'tʊː/
twmim (foreign) 't u m i m /'tʊmɪm/
twnel 't u - n e l /'tʊ.nɛl/
twrceg 't u r - k e g /'tʊr.kɛg/
twrgwyn 't u r - g uy n /'tʊr.gʊɨn/
twrnameint (foreign) t u r - 'n a - m ei n t /tʊr.'na.məɪnt/
twrnament (foreign) t u r - 'n a - m e n t /tʊr.'na.mɛnt/
twtil 't u - t i l /'tʊ.tɪl/
twymad 't uy - m a d /'tʊɨ.mad/
txta 't e k - s t @ /'tɛk.stə/
tyd 't yy d /'tɨːd/
tydach 't @ - d a x /'tə.daχ/
tydan 't @ - d a n /'tə.dan/
tydings (foreign) 't @ - d i ng s /'tə.dɪŋs/
tydio 't @ d - j o /'təd.jɔ/
tydw 't @ - d u /'tə.dʊ/
tydw (foreign) 't @ - d u /'tə.dʊ/
tydy 't @ - d y /'tə.dɨ/
tydy (foreign) 't @ - d y /'tə.dɨ/
tydyn 't @ - d y n /'tə.dɨn/
tydyn (foreign) 't @ - d y n /'tə.dɨn/
tylluanod t @ - lh y - 'a - n o d /tə.ɬɨ.'a.nɔd/
tyndale t @ n - 'd a - l e /tən.'da.lɛ/
tyngarreg t @ - 'ng a - r e g /tə.'ŋa.rɛg/
tynybedw t @ - n @ - 'b ee - d u /tə.nə.'bɛː.dʊ/
tyrol 't @ - r o l /'tə.rɔl/
tywyllach t @ - 'w @ - lh a x /tə.'wə.ɬaχ/
tywysedig t @ - w @ - 's ee - d i g /tə.wə.'sɛː.dɪg/
tâpiau 't aa p - j ay /'taːp.jaɨ/
tïm 't i m /'tɪm/
tŵf (foreign) 't uu v /'tʊːv/
u 'iu /'ɪʊ/
u (nmcy) yy - 'b e - d o l /ɨː.'bɛ.dɔl/
u-bedol yy - 'b e - d o l /ɨː.'bɛ.dɔl/
u-cwpan yy - 'k u - p a n /ɨː.'kʊ.pan/
uab 'y - a b /'ɨ.ab/
ubra iu - b ii - aa - 'r ei /ɪʊ.bɪː.aː.'rəɪ/
ucas 'iu - k a s /'ɪʊ.kas/
uchel- 'yy - x e l /'ɨː.χɛl/
uchelfa (foreign) y - x e l - v a /ɨ.χɛl.va/
uchgapten y x - 'g a p - t e n /ɨχ.'gap.tɛn/
udgyrn (foreign) 'y d - g y r n /'ɨd.gɨrn/
uel iu - ii - 'e l /ɪʊ.ɪː.'ɛl/
uemlianin w e m - l i - 'a - n i n /wɛm.lɪ.'a.nɪn/
uffar 'yy - f a r /'ɨː.far/
uffar (foreign) 'yy - f a r /'ɨː.far/
uitenhage y - i - 't e n hh aa - g e /ɨ.ɪ.'tɛnhaː.gɛ/
unarddeg y - 'n a r - dh e g /ɨ.'nar.ðɛg/
unarddeg (foreign) y - 'n a r - dh e g /ɨ.'nar.ðɛg/
unddiwylliannol y n - dh i - w @ lh - 'j a - n o l /ɨn.ðɪ.wəɬ.'ja.nɔl/
undyn 'y n - d y n /'ɨn.dɨn/
ungoes 'y - ng oy s /'ɨ.ŋɔɨs/
ungroup (foreign) 'y ng - 'r o - y p /'ɨŋ.'rɔ.ɨp/
unhcr (foreign) 'y n hh k r /'ɨnhkr/
unieithrwydd y n - 'j ei th - r uy dh /ɨn.'jəɪθ.rʊɨð/
unllawr 'y n - lh au r /'ɨn.ɬaʊr/
unpeth 'y n - p e th /'ɨn.pɛθ/
unrhywun y n - 'rh @ - w y n /ɨn.'r̥ə.wɨn/
urddaholics y r - dh a - 'hh o - l i k s /ɨr.ða.'hɔ.lɪks/
ureia (foreign) 'y r e - j a /'ɨrɛ.ja/
urmyc 'y r - m y k /'ɨr.mɨk/
urmyceg y r - 'm @ - k e g /ɨr.'mə.kɛg/
uw 'yu /'ɨʊ/
uwchaled yu - 'x a - l e d /ɨʊ.'χa.lɛd/
uwchddyn 'yu x - dh y n /'ɨʊχ.ðɨn/
uxbridge 'y k s b r i d - g e /'ɨksbrɪd.gɛ/
v (foreign) v /v/
v (nmcy) 'v ii /'vɪː/
v (nmen) 'v ii /'vɪː/
valenger v a - 'l e - ng e r /va.'lɛ.ŋɛr/
valera v a - 'l e - r a /va.'lɛ.ra/
vanya (foreign) 'v a - n @ - a /'va.nə.a/
vasto 'v a s - t o /'vas.tɔ/
vati 'v a - t i /'va.tɪ/
vatilan v a - 't i - l a n /va.'tɪ.lan/
vaughaniaid v ay g - 'hh a n - j ai d /vaɨg.'han.jaɪd/
vavasor v a - 'v aa - s o r /va.'vaː.sɔr/
vaynol (foreign) v 'a @ - n o l /v'aə.nɔl/
vde v ii - d ii - 'ii /vɪː.dɪː.'ɪː/
ve (foreign) 'v ee /'vɛː/
vedado (foreign) v e - 'd aa - d o /vɛ.'daː.dɔ/
verfassungsfeind (foreign) v e r - v a - 's y ng s - v ei n d /vɛr.va.'sɨŋs.vəɪnd/
verghese v e r g - 'hh ee - s e /vɛrg.'hɛː.sɛ/
vergil 'v e r - g i l /'vɛr.gɪl/
vers (foreign) 'v e r s /'vɛrs/
victoraidd v i k - 't o - r ai dh /vɪk.'tɔ.raɪð/
villani v i - 'lh a - n i /vɪ.'ɬa.nɪ/
vitalis v i - 't a - l i s /vɪ.'ta.lɪs/
vocab 'v oo - k a b /'vɔː.kab/
vulgaris (foreign) v y l - 'g a - r i s /vɨl.'ga.rɪs/
vychan 'v @ - x a n /'və.χan/
w 'd @ - b @ l - j uu /'də.bəl.jʊː/
w (nmcy) 'uu /'ʊː/
w3c d @ - b @ l - j uu - th r ii - 's ii /də.bəl.jʊː.θrɪː.'sɪː/
waddington w a - 'dh i ng - t o n /wa.'ðɪŋ.tɔn/
waen 'w aay n /'wɑɨn/
waendir 'w aay n - d i r /'wɑɨn.dɪr/
wai d @ - b @ - l iu - ee - 'ai /də.bə.lɪʊ.ɛː.'aɪ/
wai-aa d @ - b @ l - j uu - ei - ai - ei - 'ei /də.bəl.jʊː.əɪ.aɪ.əɪ.'əɪ/
wakestock 'w a - k e s - t o k /'wa.kɛs.tɔk/
walwyn 'w a - l uy n /'wa.lʊɨn/
wannach 'w a - n a x /'wa.naχ/
wannaf 'w a - n a v /'wa.nav/
wannaf (foreign) w 'o - n a v /w'ɔ.nav/
warnock 'w a r - n o k /'war.nɔk/
wasi 'w aa - s i /'waː.sɪ/
wasi (foreign) 'w aa - s i /'waː.sɪ/
watkin 'w a t - k i n /'wat.kɪn/
wawel 'w a - w e l /'wa.wɛl/
wawrffactor w au r - 'f a k - t o r /waʊr.'fak.tɔr/
wcrain 'u k - r ai n /'ʊk.raɪn/
wcva d @ - b @ - l iu - s ii - v ii - 'ei /də.bə.lɪʊ.sɪː.vɪː.'əɪ/
wd uu - 'd ii /ʊː.'dɪː/
wdn d @ - b @ - l iu - d ii - e n /də.bə.lɪʊ.dɪː.ɛn/
wedi'u 'w e - d i y /'wɛ.dɪɨ/
wei 'w ei /'wəɪ/
weiarles (foreign) w e - 'j a r - l e s /wɛ.'jar.lɛs/
weil 'w ei l /'wəɪl/
weilz (foreign) 'w ei l z /'wəɪlz/
weinrich 'w ei n - r i x /'wəɪn.rɪχ/
weithie 'w ei th - j e /'wəɪθ.jɛ/
weithio'n 'w ei th - j o n /'wəɪθ.jɔn/
weithrediaeth w ei th - 'r e d - j aay th /wəɪθ.'rɛd.jɑɨθ/
weldi 'w e l - d i /'wɛl.dɪ/
weldi (foreign) 'w e l - d i /'wɛl.dɪ/
welintons (foreign) w e - 'l i n - t o n s /wɛ.'lɪn.tɔns/
wella'r 'w e - lh a r /'wɛ.ɬar/
wellingtons (foreign) w e - 'lh i ng - t o n s /wɛ.'ɬɪŋ.tɔns/
welshlanguagescheme w e l - 'sh l a ng - g w i jh - s k ii m /wɛl.'ʃlaŋ.gwɪdʒ.skɪːm/
welshmusicfoundation w e l - 'sh m iu - z i k - f au n - d ee - sh @ n /wɛl.'ʃmɪʊ.zɪk.faʊn.dɛː.ʃən/
welson 'w e l - s o n /'wɛl.sɔn/
werdd 'w e r dh /'wɛrð/
wesh 'w e sh /'wɛʃ/
wesle 'w e s - l e /'wɛs.lɛ/
wesle (foreign) 'w e s - l e /'wɛs.lɛ/
wesleyaid 'w e s - 'l ey - ai d /'wɛs.'ləɨ.aɪd/
westdale 'w e s t - d ee l /'wɛst.dɛːl/
westring 'w e s - t r i ng /'wɛs.trɪŋ/
weud 'w ey d /'wəɨd/
we’r (foreign) 'w e r /'wɛr/
wh d @ - b @ - l iu - 'ee ch /də.bə.lɪʊ.'ɛːtʃ/
whitgift u - 'hh i t - g i v t /ʊ.'hɪt.gɪvt/
whiw (foreign) 'u - hh iu /'ʊ.hɪʊ/
wian 'u - 'j a n /'ʊ.'jan/
wiburn 'w ii - b y r n /'wɪː.bɨrn/
wiggington w i - 'g i ng - t o n /wɪ.'gɪŋ.tɔn/
wigston 'w i g - s t o n /'wɪg.stɔn/
wilbi 'w i l - b i /'wɪl.bɪ/
wili 'w i - l i /'wɪ.lɪ/
wiliams 'w i l - j a m s /'wɪl.jams/
wilias 'w i l - j a s /'wɪl.jas/
wiliems 'w i l - j e m s /'wɪl.jɛms/
williamsiaid (foreign) w 'i - l j @ m sh ai d /w'ɪ.ljəmʃaɪd/
willias 'w i lh - j a s /'wɪɬ.jas/
willie-llnau-ffordd (foreign) 'w i lh - 'j ee lh - 'n ay - 'f o r dh /'wɪɬ.'jɛːɬ.'naɨ.'fɔrð/
winni 'w i - n i /'wɪ.nɪ/
wisgars 'w i s - k a r s /'wɪs.kars/
wispr 'w i s - p @ /'wɪs.pə/
witsh 'w i ch /'wɪtʃ/
wix 'w i k s /'wɪks/
wnan 'nw a n /'nwan/
wnb d @ - b l iu - e n - 'b ii /də.blɪʊ.ɛn.'bɪː/
wncwl (foreign) 'u ng - k u l /'ʊŋ.kʊl/
wolfhart 'w o l v - hh a r t /'wɔlv.hart/
wordfast 'w @@ d - f aa s t /'wɜːd.faːst/
wordly (foreign) w '@r d - l ii /w'ərd.lɪː/
worldvision (foreign) w o r l - 'd v i - sh o n /wɔrl.'dvɪ.ʃɔn/
worrall 'w o - r @ l /'wɔ.rəl/
wr (foreign) 'u r /'ʊr/
wrays (foreign) r 'ei z /r'əɪz/
wre d @ - b l iu - aa - 'r ii /də.blɪʊ.aː.'rɪː/
wrextreme r e k - 's t r ii m /rɛk.'strɪːm/
wrey (foreign) r ii /rɪː/
wrey's (foreign) r ii z /rɪːz/
wrim (foreign) r 'i m /r'ɪm/
wrnod 'u r - n o d /'ʊr.nɔd/
wru d @ - b @ - l iu - aa - 'r iu /də.bə.lɪʊ.aː.'rɪʊ/
ws d @ - b l iu - 'e s /də.blɪʊ.'ɛs/
wsnos (foreign) 'u s - n o s /'ʊs.nɔs/
wsnosa u s - 'n oo - s a /ʊs.'nɔː.sa/
wsnosa (foreign) u s - 'n oo - s a /ʊs.'nɔː.sa/
wsos (foreign) 'uu - s o s /'ʊː.sɔs/
wwwwww (foreign) uu - uu - uu /ʊː.ʊː.ʊː/
wyclif 'uy k - l i v /'ʊɨk.lɪv/
wydda 'uy - dh a /'ʊɨ.ða/
wyddonias uy - 'dh o n - j a s /ʊɨ.'ðɔn.jas/
wydir 'uy - d i r /'ʊɨ.dɪr/
wyllys 'uy - lh y s /'ʊɨ.ɬɨs/
wynab (foreign) 'uy - n a b /'ʊɨ.nab/
wynfford 'uy n - f o r d /'ʊɨn.fɔrd/
wynford 'uy n - v o r d /'ʊɨn.vɔrd/
wê 'w ee /'wɛː/
x 'e k s /'ɛks/
xxxi (foreign) 'k s k s ii /'ksksɪː/
yafai @ - 'aa - v ai /ə.'aː.vaɪ/
yafais @ - 'aa - v ai s /ə.'aː.vaɪs/
yag @ - a g /ə.ag/
yallon @ - 'a - lh o n /ə.'a.ɬɔn/
ydd 'yy dh /'ɨːð/
ydd (foreign) 'yy dh /'ɨːð/
ydd (foreign) y dh /ɨð/
ydi'r '@ - d i r /'ə.dɪr/
ydy'r '@ - d y r /'ə.dɨr/
yl 'y l /'ɨl/
yl (foreign) 'y l /'ɨl/
yma'n @ - m a n /ə.man/
ymateliais (foreign) @ - m a - 't e l - j ai s /ə.ma.'tɛl.jaɪs/
ymddeoliaid @ m - dh e - 'o l - j ai d /əm.ðɛ.'ɔl.jaɪd/
ymddigiodd @ m - 'dh i g - j o dh /əm.'ðɪg.jɔð/
ymddiheurol @ m - dh i - 'hh ey - r o l /əm.ðɪ.'həɨ.rɔl/
ymenyddiol @ - m e - 'n @ dh - j o l /ə.mɛ.'nəð.jɔl/
ymfalchio @ m - 'v a l - x j o /əm.'val.χjɔ/
ymfwriodd @ m - 'v u r - j o dh /əm.'vʊr.jɔð/
ymgorfforol @ m - g o r - 'f o - r o l /əm.gɔr.'fɔ.rɔl/
ymgyfarfod @ m - g @ - 'v a r - v o d /əm.gə.'var.vɔd/
ymgymeryd @ m - g @ - 'm e - r y d /əm.gə.'mɛ.rɨd/
ymgynnig @ m - 'g @ - n i g /əm.'gə.nɪg/
ymgysuro @ m - g @ - 's y - r o /əm.gə.'sɨ.rɔ/
ymryddhaodd @ m - r @ dh - 'hh a - o dh /əm.rəð.'ha.ɔð/
ymrôdd @ m - 'r oo dh /əm.'rɔːð/
ymsoledu @ m - s o - 'l ee - d y /əm.sɔ.'lɛː.dɨ/
ymuniaethu @ - m y n - 'j aay - th y /ə.mɨn.'jɑɨ.θɨ/
ymwâu @ m - 'w aa - y /əm.'waː.ɨ/
ynadon @ - 'n aa - d o n /ə.'naː.dɔn/
yncl (foreign) '@ ng - k y l /'əŋ.kɨl/
yne (foreign) '@ - n e /'ə.nɛ/
ynghymraec (foreign) '@ ng hh @ m - r aay k /'əŋhəm.rɑɨk/
ynghŷd (foreign) '@ ng hh yy d /'əŋhɨːd/
ynglyn (foreign) '@ ng - l y n /'əŋ.lɨn/
ynglyn (foreign) '@ ng - l y n /'əŋ.lɨn/
yngwerglodd (foreign) @ ng - 'w e r - g l o dh /əŋ.'wɛr.glɔð/
ynon @ - n o n /ə.nɔn/
yntefe @ n - 't ee - v e /ən.'tɛː.vɛ/
yntefe (foreign) @ n - 't ee - v e /ən.'tɛː.vɛ/
yntê @ n - 't ee /ən.'tɛː/
ynysangharad @ - n @ - 's a ng hh a - r a d /ə.nə.'saŋha.rad/
yoma @ - 'o - m a /ə.'ɔ.ma/
yorath @ - 'o - r a th /ə.'ɔ.raθ/
youenn @ - 'oy - e n /ə.'ɔɨ.ɛn/
ypset (foreign) '@ p - s e t /'əp.sɛt/
ypsetio (foreign) @ p - 's e t - j o /əp.'sɛt.jɔ/
yrrwyr '@ - r uy r /'ə.rʊɨr/
ysbaddaden @ s - p a - 'dh aa - d e n /əs.pa.'ðaː.dɛn/
ysbiwr '@ s - p iu r /'əs.pɪʊr/
ysbrydoledd @ s - p r @ - 'd o - l e dh /əs.prə.'dɔ.lɛð/
ysbïwyr @ s - 'p i - uy r /əs.'pɪ.ʊɨr/
ysgafnach @ s - 'k a v - n a x /əs.'kav.naχ/
ysgleifion @ s - 'k l ei v - j o n /əs.'kləɪv.jɔn/
ysgrifennu'r @ s - k r i - 'v e - n y r /əs.krɪ.'vɛ.nɨr/
ysgrythyrol @ s - k r @ - 'th @ - r o l /əs.krə.'θə.rɔl/
ysgwn '@ s - k u n /'əs.kʊn/
ysgwydodd @ s - 'k uy - d o dh /əs.'kʊɨ.dɔð/
ysgyfarnogod @ s - k @ - v a r - 'n oo - g o d /əs.kə.var.'nɔː.gɔd/
ysgyrnygus @ s - k @ r - 'n @ - g y s /əs.kər.'nə.gɨs/
ysgythrog @ s - 'k @ th - r o g /əs.'kəθ.rɔg/
ystad '@ s - t a d /'əs.tad/
ystlumod @ s - 't l y - m o d /əs.'tlɨ.mɔd/
ystol '@ s - t o l /'əs.tɔl/
ystorio @ s - 't o r - j o /əs.'tɔr.jɔ/
ystorya (foreign) @ s - 't o - r @ - a /əs.'tɔ.rə.a/
ystoryaeu (foreign) @ s - 't o - r @ - 'aay - y /əs.'tɔ.rə.'ɑɨ.ɨ/
ystyrioldeb @ s - t @ r - 'j o l - d e b /əs.tər.'jɔl.dɛb/
ystyrlawn @ s - 't @ r - l au n /əs.'tər.laʊn/
ystyron @ s - 't @ - r o n /əs.'tə.rɔn/
yts 'y t s /'ɨts/
yttriwm (foreign) '@ t - r iu m /'ət.rɪʊm/
yuppiaidd @ - 'y p - j ai dh /ə.'ɨp.jaɪð/
yuppiaidd (foreign) @ - 'y p - j ai dh /ə.'ɨp.jaɪð/
yyb yy b /ɨːb/
z 'z e d /'zɛd/
zacco 'z a - k o /'za.kɔ/
zbyszko 'z b @ s - z k o /'zbəs.zkɔ/
zeugly 'z ey g - l y /'zəɨg.lɨ/
zodshop 'z o d - sh o p /'zɔd.ʃɔp/
zola (foreign) 'z o - l a /'zɔ.la/
zpd z e d - p ii - 'd ii /zɛd.pɪː.'dɪː/
zulema z y - 'l e - m a /zɨ.'lɛ.ma/
zulemita z y - l e - 'm i - t a /zɨ.lɛ.'mɪ.ta/
zwingli 'z w i ng - l i /'zwɪŋ.lɪ/
ê 'ee /'ɛː/
ío ai - 'oo /aɪ.'ɔː/
îs 'ii s /'ɪːs/
ô 'oo /'ɔː/
ŵ 'uu /'ʊː/
ŷ 'yy /'ɨː/
